㨖: ['擹']
㫚: ['曶']
䧹: ['雁']
䳭: ['鵩', '鶍', '鸊', '鸍']
丁: ['丿', '丅', '工', '亅', '疒']
丂: ['丌', '丑', '幵']
七: ['丶']
丄: ['丬', '人']
丅: ['沰', '工', '丁', '汅']
丆: ['乀', '广', '卉', '宂', '它', '勹']
万: ['丌', '刃']
上: ['丨']
下: ['疋']
丌: ['丂', '丑', '幵', '万']
不: ['不']
丏: ['丐']
丐: ['丏']
丑: ['丂', '丌']
丒: ['卫']
且: ['尼', '巨']
丗: ['讥']
丙: ['円']
东: ['來', '來']
丟: ['汞']
两: ['襾']
丧: ['良']
丨: ['十', '讠', '上']
个: ['十', '犭', '讠', '士', '夵', '丨']
丬: ['丄', '人']
中: ['市', '屯']
丯: ['氵']
串: ['串']
丵: ['峷']
丶: ['七']
丷: ['二', '刂', '让', '卝', '认', '汄']
丸: ['穴', '九']
丹: ['冎', '丹']
为: ['六', '冘']
主: ['巠', '金', '仐']
丿: ['儿', '汣', '丅', '丁', '亅']
乀: ['乛', '乂', '辶', '广', '又', '丆', '乚']
乁: ['乊', '丶', '义']
乂: ['乀', '又']
乃: ['升']
乄: ['爫']
义: ['乁']
乊: ['了', '乁', '卢']
乎: ['妥']
乐: ['圡']
乑: ['來', '來']
乔: ['岕']
乖: ['秊', '乘', '季', '秊']
乘: ['乖', '沗']
乚: ['辶', '乀', '亅']
乛: ['辶', '乀', '尸']
九: ['冗', '咒', '亣', '丸']
习: ['污']
乡: ['纟']
乢: ['吣']
乫: ['乲']
乬: ['軎']
乯: ['乧']
乲: ['乫', '空']
乵: ['軋']
乶: ['茰']
乹: ['軌']
乾: ['亁']
亁: ['乾']
亂: ['薍']
亅: ['泟', '丿', '入', '汪', '辷', '丁', '尣', '乚', '汼']
了: ['了', '卫']
亊: ['革', '荜']
事: ['寧', '挚']
于: ['干']
云: ['五']
互: ['瓦']
亓: ['元', '齐', '汢', '汀', '斤']
五: ['云']
井: ['幷', '并', '汼']
亗: ['舌']
亡: ['厃']
亢: ['介']
亣: ['穴', '六', '九', '夰']
亨: ['芓', '草', '阜', '卓']
亩: ['岜']
享: ['臭', '凖', '皁', '亭']
亭: ['毫', '享', '臬']
亰: ['朿', '宇', '束']
亴: ['蔩']
亵: ['裒']
亶: ['靊', '豊', '鼟']
人: ['丄', '火', '丬']
亻: ['卞', '冫', '千', '子', '土']
亽: ['爫', '冖']
亿: ['佦', '仩']
什: ['什']
仁: ['辶', '广', '白', '匸']
仄: ['圧']
仅: ['伔', '位', '仨', '伐']
仆: ['尓']
仇: ['倂', '讥', '佐']
仈: ['爪', '仏']
仉: ['见', '汃', '汎']
介: ['灮', '亢']
仏: ['仈', '汄']
仐: ['主', '金']
仓: ['合']
仔: ['任', '倅', '侔', '茌', '仦']
仕: ['恮', '讧', '伙', '让', '仜', '佂', '玒', '仩']
他: ['灺', '彵']
仗: ['住']
付: ['价']
仙: ['仩']
仚: ['屳', '峃']
仛: ['仠']
仜: ['仕', '讧', '让', '疘', '佂', '伍', '玒', '疝', '证']
仝: ['全']
仟: ['玕', '灹', '坾', '忹', '坏']
仠: ['柸', '讦', '仛']
仢: ['匂']
代: ['伐']
仦: ['任', '仔', '佇']
仨: ['伔', '还', '仅']
仩: ['仕', '亿', '仙']
仪: ['仗', '佼']
仭: ['伿']
仮: ['侫']
仱: ['件']
仲: ['冲', '伷', '并']
仳: ['伧']
仵: ['怢', '件']
件: ['玣', '仵', '住', '伴']
价: ['论', '付', '侊']
仹: ['沣', '伂']
任: ['怔', '仔', '仼', '荰', '仦']
仼: ['任', '荘']
份: ['抍', '仿', '坋']
仾: ['讵', '诅', '百', '怇']
仿: ['份', '纺']
伀: ['化']
伂: ['伃', '作', '仹']
伃: ['沶']
伆: ['侚']
伉: ['恠', '侁', '仡', '佼']
伋: ['伖', '汲']
伌: ['伲', '伛']
伍: ['仜', '佂']
伎: ['俠', '侒', '侠']
伏: ['佸']
伐: ['代']
伓: ['怌']
伔: ['仅', '仨', '仉']
伕: ['伙', '佒']
伙: ['仕', '佒', '沙']
伛: ['俋', '伌']
伝: ['低', '侊']
伞: ['雽']
伟: ['炜']
伡: ['榟', '谇']
伢: ['冴']
伣: ['侸']
伦: ['忙', '坨']
伧: ['仳']
伨: ['句', '句', '们', '勺']
伫: ['汒']
伭: ['侬', '依', '俧', '佉', '侅']
伯: ['佰']
估: ['往', '佮', '佑']
伲: ['泥', '伌', '泥']
伴: ['烰', '拌', '伅', '件', '怑']
伵: ['怬', '佣']
伶: ['狑', '佡', '炩', '坽']
伷: ['仲', '佃']
伹: ['沮', '侶', '佢']
伺: ['词']
伻: ['泙']
伾: ['伍']
伿: ['仭', '识', '但']
佀: ['侣']
佁: ['佮']
佂: ['仕', '讧', '仜', '伍', '玒', '疝', '证']
佃: ['伷']
佅: ['侏', '俅']
但: ['怛', '泹', '伿']
佇: ['怍', '仦']
佉: ['倸', '伭']
佋: ['绍', '佰', '炤']
佌: ['讹']
位: ['仅', '仨']
低: ['伝', '诋', '忯']
住: ['玣', '仗', '倥', '件', '佐']
佐: ['住', '仇']
佑: ['玷', '估']
佒: ['伙', '伕', '佼']
何: ['坷']
佖: ['泌']
佗: ['炨', '忔', '论']
佘: ['汆']
余: ['呆']
佚: ['蚗']
佛: ['佻', '俙']
作: ['伂']
佟: ['佫']
佢: ['伹', '巨']
佣: ['伵']
佤: ['怋']
佦: ['亿']
佨: ['俗']
佪: ['悃', '徊']
佫: ['洛', '供', '洛', '俈', '悋', '佟', '佮']
佮: ['怆', '炲', '佁', '佫', '估', '傜', '烚', '铪', '殆']
佯: ['详', '徉']
佰: ['伯', '佋']
佱: ['歪']
佳: ['徍']
併: ['倂']
佶: ['倍', '倠']
佷: ['恨']
佸: ['伏', '恬', '后']
佻: ['侥', '佛']
佼: ['恔', '仪']
佾: ['洕', '侜']
使: ['倖']
侁: ['伉']
侂: ['兖']
侃: ['促']
侄: ['恮', '伃', '烇']
侅: ['惔', '俧', '伭']
來: ['乑', '来', '來', '东']
侇: ['傏']
侉: ['侤', '借']
侊: ['伝', '恍', '价']
侍: ['泋', '恃', '洔']
侎: ['倸']
侏: ['佅', '俅']
侑: ['侜', '洧']
侒: ['伎']
侓: ['浡']
侔: ['仔']
侗: ['個', '泂']
侙: ['仗']
侚: ['伆']
供: ['佫']
侜: ['佾']
依: ['烋', '侬', '伭']
侞: ['洳']
侟: ['斿']
侠: ['炔', '伎']
侢: ['悟', '侽']
侣: ['佀', '侶']
侤: ['侉']
侥: ['佻']
侧: ['测', '測', '惻', '側']
侩: ['偎', '俭']
侫: ['倿', '傁', '仮']
侬: ['依', '佉', '伭']
侯: ['矦', '俟']
侰: ['语', '偌', '焐', '倨', '涒']
侱: ['俚']
侳: ['淫', '俓']
侵: ['傁', '惾', '僓', '梫']
侶: ['伹', '侣']
侷: ['偱']
侸: ['恆', '伣']
侺: ['伴', '沣', '涔']
侼: ['痔']
侽: ['侢', '倨']
侾: ['俾']
便: ['偎', '便', '倱']
俀: ['佞']
促: ['浞', '傜']
俅: ['佅', '侏']
俉: ['恺', '浯', '俋']
俊: ['倭', '俟', '倓']
俋: ['俉', '傜', '伛']
俌: ['烳']
俍: ['傀', '愧']
俏: ['消', '诮', '傍']
俐: ['俰']
俑: ['個']
俓: ['侳', '淫', '涩', '徑', '愮']
俔: ['倨']
俖: ['倥', '迗']
俗: ['佨', '浴']
俙: ['佛']
俚: ['悭', '悝', '侱', '偛', '樫']
俜: ['挎', '惇', '停']
保: ['僇']
俟: ['俊', '矦', '侯']
俠: ['烋', '伎']
信: ['倽']
俢: ['偬']
俥: ['僤', '儐', '傽']
俦: ['倚', '偆', '倬']
俧: ['伭', '侅']
俪: ['俷']
俫: ['倧', '僚', '僚', '倞', '浨']
俭: ['侩']
俰: ['倁', '俐']
俱: ['倶']
俳: ['渄']
俵: ['偯']
俷: ['俪']
俸: ['億', '漳', '儚']
俻: ['瘩']
俼: ['儕']
俾: ['侾', '椑']
倀: ['悵']
倁: ['俰']
倂: ['併']
倅: ['仔', '侔', '谇', '伡']
個: ['悃', '俑', '涸', '悯', '侗']
倌: ['悺']
倍: ['佶', '涪']
倏: ['候']
倐: ['惔']
倓: ['俊', '偀']
倔: ['倡']
倖: ['使', '倬']
倗: ['倜', '淜', '側', '憫']
倘: ['倜']
候: ['倏']
倚: ['徛', '渏', '傄', '俦', '倬', '偝']
倜: ['倘', '徟', '僪', '倗', '湡']
倝: ['軼']
倞: ['倧', '椋', '偯', '俫', '淙']
借: ['侉']
倠: ['佶', '悎']
倣: ['微', '做']
倥: ['住', '俖']
倦: ['惓']
倧: ['俫', '淙', '倞']
倨: ['语', '侰', '侽', '俔']
倩: ['懠', '清', '傐', '懏']
倫: ['偸', '倫']
倬: ['倚', '倖', '傄', '俦']
倭: ['俊']
倰: ['後', '傻']
倱: ['偎', '便', '惃', '便']
倲: ['徚', '傢']
倳: ['僤']
倶: ['俱']
倸: ['侎', '佉']
倹: ['瘐', '僙']
债: ['償']
倻: ['郔', '假']
值: ['揎', '逭', '傖']
倽: ['信']
倾: ['傾']
倿: ['侫', '痒']
偀: ['倓']
偃: ['惿', '僇', '儨', '慪', '愝', '偍', '樞']
偅: ['傞', '潬']
偆: ['傄', '俦']
假: ['倻']
偈: ['渴']
偉: ['億', '浲']
偌: ['侰']
偍: ['惿', '偃']
偎: ['便', '侩', '倱', '徰', '煨', '便']
偏: ['傓']
偒: ['儞']
偓: ['僵', '渥']
做: ['倣', '傤']
偛: ['俚']
停: ['癌']
偝: ['倚']
偟: ['傗']
偠: ['傁', '僫']
偡: ['煁']
偣: ['徣', '煯', '涾', '湆']
健: ['缠']
偦: ['傦']
偧: ['儚']
偬: ['傯']
偭: ['愐']
偯: ['滾', '倞', '俵']
偱: ['侷']
偲: ['傯']
偳: ['慍']
側: ['侧', '测', '測', '惻', '倗']
偵: ['傁']
偷: ['崳']
偸: ['倫']
偽: ['媯']
傀: ['迍', '俍']
傁: ['侫', '儐', '侵', '偵', '偠']
傃: ['儴']
傄: ['倚', '偆', '倬', '庴']
傅: ['憳', '煿']
傊: ['熉']
傋: ['傽']
傍: ['俏']
傎: ['僡']
傏: ['侇']
傐: ['倩']
傒: ['儾']
傓: ['偏']
傖: ['值', '儋']
傗: ['儐', '偟']
傘: ['夆', '皐', '臯']
傜: ['促', '滛', '佮', '俋', '徭']
傝: ['溻']
傞: ['偅']
傟: ['滃']
傢: ['倲']
傣: ['瘝']
傦: ['偦']
傫: ['漯']
傮: ['情', '櫿']
傯: ['偬', '偲']
傲: ['僌']
傳: ['僼', '價', '儔']
傴: ['愜', '惱']
債: ['僤', '倳', '儧', '僇', '儥', '僨', '僖', '僓']
傸: ['僚', '僚']
傻: ['痿', '倰']
傼: ['儳']
傽: ['僤', '暲', '傋', '障', '僨', '俥', '僋']
傾: ['倾']
傿: ['漹']
僁: ['僽']
僃: ['侕']
僆: ['倢']
僇: ['憀', '偃', '保', '儞']
僋: ['僤', '儐', '儧', '傽']
僌: ['傲', '敹']
働: ['慟']
像: ['湪']
僐: ['噟']
僒: ['痯']
僓: ['債', '儇', '檈', '儥']
僔: ['僐']
僖: ['債', '儥']
僙: ['懴']
僚: ['僚', '傸', '俫']
僜: ['橙']
僡: ['傎', '憶', '慬']
僣: ['僭', '瘖']
僤: ['倳', '儨', '俥', '傽']
僥: ['憢']
僨: ['債', '儧', '儨', '傽', '隫']
僩: ['僴', '潣', '侀']
僪: ['倜']
僫: ['偠']
僭: ['憯', '溍', '僣', '儅']
僮: ['億', '憓']
僯: ['燐', '燐']
僲: ['價']
僳: ['儏']
僴: ['澗', '僩']
僵: ['偓', '優', '儓', '殭']
僸: ['儊', '慌']
價: ['僲', '懁', '儥', '儹']
僼: ['傳', '憛']
僽: ['僁']
僾: ['儠']
儁: ['懏', '愯']
儂: ['櫦']
億: ['僮', '癋', '俸']
儅: ['惽', '僭']
儇: ['儥', '僓']
儈: ['偷', '徻']
儊: ['僸']
儏: ['僳']
儐: ['渲', '傁', '俥', '僋', '傗']
儑: ['湨']
儓: ['優', '僵']
儔: ['傳', '儥', '價']
儗: ['懝']
儙: ['缱']
儚: ['偧', '俸']
儜: ['僒']
儞: ['儥', '偒']
儠: ['僾']
儣: ['橫', '傸']
儤: ['澋']
儥: ['價']
儦: ['犥']
儧: ['儨', '儥', '儹', '溳', '僋']
儨: ['僤', '儥', '愼', '偃']
優: ['儓', '僵', '儮']
儮: ['儼']
儳: ['傼']
儴: ['傃']
儵: ['絛', '儻']
儹: ['儧', '儥', '價']
儻: ['儵']
儼: ['儮']
儾: ['欜', '傒']
儿: ['丿', '凡']
兀: ['兀', '刂']
允: ['兄', '尣', '灮']
兂: ['先', '圥']
元: ['亓', '汈', '斤']
兄: ['允', '尣']
先: ['圥', '兂']
光: ['灮', '亢']
兊: ['尣', '兌']
克: ['宪', '完']
兌: ['兊']
兎: ['臣']
兑: ['兕', '尣']
兒: ['兕']
兕: ['兑', '兒', '咒']
兖: ['侂']
党: ['觉']
兛: ['剋']
兝: ['兞']
兞: ['兝']
兤: ['黋']
入: ['六', '亅']
全: ['仝', '圶']
八: ['癶']
六: ['入']
兮: ['片']
具: ['萈']
养: ['荞']
冀: ['藁']
冂: ['冃', '旧', '闩', '臼', '囗', '厂', '乚', '匸', '门']
内: ['禸', '旳']
円: ['巴', '丙']
冈: ['𠀀', '閁']
冉: ['再']
冋: ['而']
册: ['卌']
再: ['冉']
冎: ['丹', '丹']
冏: ['同']
冐: ['胃']
冑: ['胄', '眢']
冕: ['罠']
冖: ['爫', '亽', '旪']
冗: ['九', '宄', '江', '宂']
冘: ['为', '尤']
冚: ['山', '爪', '四']
农: ['叹']
冞: ['宩']
冫: ['訁']
冲: ['仲']
冴: ['伢']
况: ['呪']
冹: ['凌']
冻: ['陈']
冾: ['抬', '珆', '姶']
凁: ['凃']
凃: ['凁', '凎']
凅: ['堌']
凉: ['凉']
凊: ['淆']
凌: ['冹']
凎: ['飡', '凃']
减: ['堿']
凑: ['溱']
凕: ['渜']
几: ['凢', '凣']
凡: ['儿', '圱']
凢: ['几', '户', '凣']
凣: ['卩', '几', '凢', '斤']
処: ['虮']
凮: ['屄', '夙']
凰: ['蜃']
凱: ['凯']
凴: ['憑']
凵: ['二']
凶: ['凷']
凷: ['畄', '凶']
凹: ['匚', '彐', '归', '臼']
出: ['岀']
击: ['市']
刁: ['乙']
刂: ['兀', '兀', '丷', '吖', '卝']
刃: ['囚', '万']
分: ['一']
切: ['扨']
刈: ['刘']
刋: ['刘']
刐: ['則']
刑: ['刓', '別']
刓: ['汌', '刑']
刔: ['刦', '効']
列: ['刞']
刘: ['刈', '刋']
刜: ['劍']
初: ['牣', '朷', '忉']
刞: ['列']
判: ['刮']
刦: ['刔']
刧: ['却']
利: ['刮', '利']
刬: ['剑', '劀']
刮: ['判', '利', '利']
刹: ['釗', '刺', '刺']
刺: ['剠', '刹', '刺']
刿: ['剑']
剁: ['剠']
剂: ['剤']
剄: ['剰']
則: ['刐']
剋: ['兛']
剌: ['剠', '剎']
剎: ['剌']
剐: ['剮']
剑: ['刬']
剖: ['剳']
剛: ['剾']
剠: ['剁', '剌', '刺', '刺']
剥: ['剰']
剮: ['剐']
剰: ['剄', '剥']
剳: ['剖']
剹: ['劉', '劉']
剼: ['劋']
剾: ['圊', '剛', '圖']
劀: ['刬']
劉: ['劉', '剹']
劋: ['剼']
劍: ['刜']
劓: ['鼼']
劕: ['劗']
劗: ['劕']
力: ['力']
劜: ['灶']
功: ['卭']
劥: ['勂', '勀']
助: ['肋', '肋']
劰: ['勆']
労: ['屴']
効: ['刔']
勀: ['劥']
勂: ['劥']
勆: ['劰']
勈: ['勣']
勌: ['勠']
勐: ['勜']
勒: ['勒', '勘']
勘: ['勒', '勒']
勛: ['崱']
勜: ['勭', '勐']
勞: ['勞']
募: ['慕']
勠: ['勌']
勣: ['勈']
勪: ['勵', '勵', '勴']
勬: ['勳']
勭: ['勜']
勳: ['勬']
勴: ['勵', '勵', '勪']
勵: ['勵', '勪', '勴']
勹: ['广', '丆']
勺: ['匆', '汋', '句', '句', '匀', '匂', '伨']
勻: ['勾', '匇']
勼: ['灳']
勾: ['勻']
匀: ['匃']
匂: ['匆', '仢', '句', '句', '匄', '伨']
匃: ['匀']
匄: ['匂', '勼', '灳']
匆: ['句', '句', '匂']
匇: ['甸', '勻']
匍: ['匎']
匎: ['訇', '匍']
匐: ['訇']
化: ['玌', '伀']
北: ['北']
匚: ['彐', '工', '疒', '凹', '匸']
匜: ['匼', '匟']
匟: ['匜']
匡: ['匳', '匤', '厓', '匧', '医']
匣: ['匧']
匤: ['匡', '厓', '医']
匥: ['匮', '匬']
匧: ['匣', '匳', '医']
匨: ['圊']
匩: ['匳']
匫: ['厪', '匲', '匷']
匬: ['匥']
匮: ['匥']
匱: ['麆', '國', '匾', '匼', '圕', '匿']
匲: ['匫']
匳: ['匡', '匩', '匧']
匷: ['匫']
匸: ['仁', '辶', '广', '只', '江']
医: ['匤', '匡', '匧']
匼: ['囹', '匱', '匜']
匾: ['圛', '匱', '圕']
十: ['讠', '个', '士', '丨']
千: ['亻']
卄: ['吐', '长', '汘']
卆: ['羋']
升: ['竚', '乃', '卜', '幵']
卉: ['丆']
半: ['歩']
卋: ['户']
卌: ['册']
卍: ['彤']
卑: ['率', '率']
卓: ['稟', '草', '車', '皇', '車']
協: ['恊']
单: ['単']
卖: ['葖', '秶']
南: ['苘']
単: ['罦', '单']
博: ['愽', '煿', '燇']
卛: ['奱']
卜: ['亠', '升', '讣']
卝: ['乊']
卞: ['亻']
卟: ['叺']
卡: ['末', '笇']
卢: ['乊']
卦: ['荓']
卩: ['几', '凣', '斤']
卫: ['了', '丒']
卭: ['功']
卮: ['巵']
卯: ['印']
印: ['卯']
却: ['刧']
卸: ['缷']
卿: ['蝍']
厂: ['乛', '冂', '辶', '乀', '广', '江', '汓', '厃', '尸', '匸']
厃: ['广', '亡', '片']
厇: ['圧']
厓: ['匤', '匡']
厔: ['魇', '垕']
厙: ['澤']
厜: ['屋']
厝: ['眉']
厡: ['厱']
厣: ['屓']
厪: ['愿', '蜃', '匫', '廤']
厬: ['麐']
厮: ['尾']
厯: ['愳']
厵: ['龘']
厶: ['一']
县: ['虽', '显']
叀: ['枣']
参: ['參', '參']
參: ['參', '叅']
叆: ['瑷']
又: ['父', '乂', '乀', '艾']
収: ['收']
叏: ['妥']
叒: ['叕']
叓: ['麦', '茛']
叕: ['叒']
变: ['叟', '萝', '姿']
叟: ['变', '萝']
口: ['曰', '囗', '门']
句: ['匆', '句', '勺', '匂', '伨']
只: ['汓', '疒', '匸']
叭: ['叽']
叮: ['帄', '忊']
台: ['色', '合']
叴: ['台', '合', '夻']
叵: ['回', '洰', '囙']
叶: ['叿']
叺: ['卟']
叽: ['呎', '叭', '吮', '呪']
叾: ['啠']
叿: ['叶', '吙']
吀: ['吁', '轩', '讦', '紆', '奷', '竏', '吥', '纡']
吁: ['轩', '訏', '訐', '吀', '奷', '竏', '吥']
吃: ['圪', '纥', '呁']
各: ['舎', '吝']
吇: ['荰', '荘', '旪']
合: ['台', '仓', '呰', '叴']
同: ['囘', '冏']
后: ['佸']
吏: ['吏', '莡']
吐: ['卄']
吒: ['阫', '託', '吓']
吓: ['吒', '坏']
吔: ['吪', '阤']
吖: ['吘', '刂', '旿']
吘: ['吨', '吖', '呯', '旿']
吙: ['吹', '呅', '呐', '叿', '呔', '吠', '吷', '呮']
吜: ['钮', '呪']
吝: ['各', '宫', '吝']
吟: ['袊']
吠: ['状', '呔', '吙']
吡: ['呛', '吮']
吣: ['屾', '乢']
吤: ['妎', '吭', '祄', '衸']
吥: ['吁', '吀']
吨: ['吘', '扽']
吩: ['昐', '纷', '秎', '咞']
吪: ['毗', '吔']
含: ['舍']
听: ['岓', '妡', '訢']
吭: ['吤', '忼', '粇']
吮: ['呚', '吡', '叽', '呪']
吰: ['咕']
吱: ['呿', '呟', '咳', '昧', '味', '昩', '咣', '哝']
吲: ['咟']
吴: ['晏']
吵: ['嗖']
吶: ['呐']
吷: ['咬', '吙']
吸: ['哏']
吹: ['呚', '吙', '忺']
吺: ['唆', '哸']
吻: ['咐', '嘮', '咰', '啕']
吼: ['咓']
吽: ['呼', '咋', '旪']
呀: ['蚜']
呁: ['吃']
呂: ['呂']
呃: ['呱', '呢']
呅: ['呚', '哎', '吙']
呆: ['罙', '余']
呇: ['咨']
呈: ['昰']
告: ['呰']
呋: ['哾', '袂']
呎: ['叽', '呪', '呮']
呐: ['吶', '吙']
呔: ['汰', '状', '犾', '吠']
呕: ['呗', '呬']
呖: ['枥']
呗: ['坝', '呕', '呞']
呚: ['吹', '呅', '吮']
呛: ['吡', '哈', '唅', '咍', '咱']
呝: ['喥']
呞: ['啊', '昫', '呗']
呟: ['吱', '呿', '咳', '味', '哝', '唻']
呢: ['呃', '呱']
呤: ['秢']
呥: ['嗂']
呧: ['吼']
周: ['局']
呪: ['呎', '况', '吜']
呫: ['咕']
呬: ['啊', '嘓', '呕', '啯']
呮: ['呎', '咁', '吙']
呯: ['哷', '吘', '垀', '评', '呵', '坪']
呰: ['告', '合']
呱: ['呃', '呢']
呲: ['咈', '哑']
味: ['吱', '呿', '呟', '昩', '咪', '唻']
呴: ['咋', '咱']
呵: ['呯', '眄']
呸: ['杠', '阫', '彺', '狂']
呹: ['畉']
呻: ['呥', '哔']
呼: ['吲', '哶', '吽']
呿: ['吱', '呟', '味', '哝', '唻']
咀: ['咱']
咁: ['唂', '玵', '哈', '咍', '呮']
咂: ['咽', '哑']
咄: ['咶']
咆: ['唎']
咈: ['昲', '呲']
咉: ['唊']
咋: ['秨', '拃', '吽']
咍: ['咟', '咕', '给', '呛', '哈', '唅', '咁', '咱']
咐: ['吻', '附']
咒: ['兕', '九']
咓: ['吼']
咕: ['吰', '咟', '秙', '呫', '轱']
咗: ['袏']
咘: ['唽', '哊']
咙: ['垅', '嗌', '眬', '昽', '哤']
咛: ['竚', '聍']
咜: ['坨']
咞: ['岍', '吩', '竔', '妍', '蚈']
咟: ['吲', '咕', '姡', '竡']
咠: ['膏']
咣: ['吱', '昧']
咤: ['垞']
咥: ['唑']
咦: ['眱', '喤']
咨: ['呇']
咩: ['祥']
咪: ['嗏', '味', '昩']
咬: ['狡', '吷']
咭: ['唁']
咮: ['珠', '硃']
咰: ['眴', '吻', '昫', '眗']
咱: ['咀', '呛', '唅', '咍']
咳: ['吱', '垓', '咴', '哝', '唻']
咴: ['咳', '唺']
咵: ['晇']
咶: ['咄']
咷: ['垗', '哓', '唴', '咻']
咸: ['威', '烕']
咹: ['唆']
咻: ['咷']
咽: ['啹', '嚯', '嘔']
哀: ['裒']
哂: ['硒', '晒']
哃: ['晍']
哇: ['嗤']
哈: ['给', '呛', '唅', '咍', '咁', '咱']
哉: ['菣', '戢', '烖']
哊: ['詴', '咘']
哌: ['嘅', '喉', '啋', '嘥', '噞', '嘫']
响: ['嘘', '唵', '哺']
哎: ['呅']
哏: ['吸']
哐: ['喔', '啀']
哑: ['噁', '呲', '哦', '嚁']
哒: ['挞']
哓: ['哙', '咷']
哔: ['呻']
哖: ['啐', '姩']
哗: ['哻']
哘: ['垳']
哙: ['唼', '哓']
哚: ['垛', '唻']
哜: ['挤', '阩']
哝: ['吱', '呿', '呟', '咳', '味']
哞: ['啈']
員: ['貸', '資', '賀', '貢', '灵']
哢: ['硦']
哤: ['咙', '眬', '昽']
哦: ['娥', '睋']
哨: ['弰']
哩: ['唱']
哪: ['唧']
哮: ['啍', '涍']
哯: ['睍']
哰: ['哼']
哲: ['晢', '皙', '晳']
哳: ['晰', '啦']
哴: ['啭', '埌']
哶: ['呼', '吽']
哷: ['呯']
哸: ['唆', '吺']
哻: ['晘', '哗', '哩', '唱', '喝']
哼: ['啍', '哰']
哽: ['喂', '喽', '唩', '埂']
哾: ['呋', '棁', '娧']
唁: ['噜', '娮', '咭']
唂: ['峪', '輍', '咁']
唃: ['喇', '嗚', '喇']
唅: ['呛', '哈', '咍', '咱']
唆: ['唼', '哸', '稄', '咹', '竣', '吺']
唇: ['磿']
唈: ['啹', '咽', '嚿']
唉: ['竢', '喚', '唤', '唺']
唊: ['咉', '陜', '埉', '峽']
唍: ['晥', '暁', '啘']
唎: ['喇', '咆', '喇']
唏: ['晞']
唐: ['賡', '廗', '磨']
唑: ['咥']
唓: ['啅']
唕: ['啽']
唖: ['喕']
唗: ['啶']
唚: ['啰']
唝: ['嗘']
唢: ['晱']
唤: ['唉', '暎']
唥: ['昤', '竛']
唧: ['哪']
唩: ['哽', '喂', '喽']
唪: ['皡', '嘒']
唭: ['琪', '嗛']
唱: ['哻', '晿', '哩', '喝']
唲: ['婗', '晲', '晀']
唴: ['咷', '嗴']
唵: ['响']
唶: ['隌']
唷: ['噜', '嘮', '嗋', '啃', '隮']
唺: ['咴']
唻: ['呿', '呟', '咳', '昧', '味', '昩', '哚']
唼: ['唆', '哙']
唽: ['晰', '咘', '啉', '哳']
啀: ['哐', '喔']
啃: ['噜', '噌', '唷']
啅: ['唓', '踔']
啈: ['哞', '啤']
啉: ['唽']
啊: ['嗕', '嘓', '呬', '呞']
啋: ['哌']
啌: ['腔']
啍: ['哼', '哮']
啎: ['牾']
啐: ['哖']
啒: ['喱']
啓: ['晵']
啕: ['祹', '吻', '陱']
啖: ['裧']
啘: ['晥', '喨', '唍']
啚: ['畕']
啛: ['噫']
啜: ['辍']
啝: ['哦']
啠: ['叾', '哲']
啤: ['啈']
啦: ['哳']
啧: ['嘜', '啮']
啨: ['啃', '嚕', '嘖']
啬: ['奤', '嗇', '富']
啭: ['哴', '噋']
啮: ['啧', '咽']
啯: ['嘓', '呬']
啰: ['嘤', '嘐', '唚', '噿', '噮']
啴: ['暭', '弹']
啵: ['鞁']
啶: ['噬', '唗', '噰']
啷: ['喞']
啸: ['嗉', '曠']
啹: ['咽', '唈', '嗂']
啺: ['暘']
啼: ['嘀']
喁: ['嗶']
喂: ['隈', '哽', '喽', '唩']
喅: ['隈', '喂', '嗢', '喔']
喇: ['唎', '喇', '唃', '嗬']
喋: ['弽', '堞']
喍: ['暕']
喑: ['嗐']
喒: ['噌', '嗐']
喓: ['嘤', '嘙', '嗖', '噯']
喔: ['喅', '哐', '囉', '嗢', '啀']
喕: ['唖', '缅']
喗: ['嗯', '揮', '嚯', '暉', '嗿']
喘: ['噊', '腨', '端']
喙: ['嚥']
喚: ['唉']
喜: ['冪', '霊']
喝: ['哻', '唱', '噣', '噚']
喞: ['啷']
喟: ['噜', '嘖']
喡: ['暲', '偉']
喢: ['嗖', '噯']
喣: ['煦']
喤: ['咦']
喥: ['呝']
喦: ['嵒']
喧: ['噜', '嗐']
喨: ['嗔', '啘']
喱: ['啒']
喴: ['嘁']
営: ['官']
喷: ['曂', '嗩']
喻: ['睮', '揄', '堬', '嚨']
喽: ['哽', '喂', '唩', '嗺']
喿: ['棠']
嗀: ['嗀', '榖']
嗁: ['榹']
嗂: ['啹', '呥']
嗃: ['噧', '噫']
嗄: ['暥', '嚘']
嗅: ['暣', '噢']
嗆: ['愴', '噥', '嚰']
嗇: ['啬']
嗉: ['嚝', '嗪', '啸', '嚛', '嗿']
嗊: ['噯']
嗋: ['嘮', '嗕', '嗗', '嘻', '噆', '唷']
嗌: ['咙']
嗎: ['禡', '嚿']
嗏: ['咪']
嗐: ['喑', '嚀', '喧', '嚰', '喒']
嗓: ['褬']
嗔: ['喨']
嗕: ['啊', '嗋', '嗗']
嗖: ['喓', '嘙', '噯', '吵', '喢']
嗗: ['嘮', '嗋', '嗕']
嗘: ['唝']
嗙: ['膀']
嗚: ['唃', '嘀']
嗛: ['噪', '唭']
嗜: ['嚌', '噆']
嗝: ['塥', '隔']
嗞: ['晎']
嗡: ['嚖', '瞈', '暡']
嗢: ['喅', '喂', '褞', '喔']
嗤: ['暟', '哇']
嗥: ['暭', '嚝']
嗩: ['喷']
嗪: ['嗉', '哞', '嚝', '啸']
嗬: ['喇', '喇']
嗯: ['喗', '嚯', '嘔']
嗱: ['曍']
嗳: ['嘤', '禐', '暧', '噮']
嗴: ['唴']
嗶: ['喁', '嘽']
嗷: ['磝']
嗹: ['曃']
嗺: ['喽']
嗻: ['噰']
嗼: ['嚽']
嗿: ['喗', '嗉']
嘀: ['摘', '嗚', '啼']
嘁: ['喴', '嚱']
嘃: ['噏']
嘄: ['噪', '噄']
嘅: ['哌']
嘈: ['晴']
嘊: ['曥']
嘋: ['噋']
嘌: ['瞟', '嚯', '缥', '嚛', '嘚', '嘕']
嘍: ['嘎']
嘎: ['嘍']
嘐: ['嘤', '噿', '嚖', '啰']
嘓: ['啊', '啯']
嘔: ['嗯', '咽', '嚯']
嘕: ['嚅', '鳴', '嘌']
嘖: ['噴', '喟', '嚋', '啨', '嚕']
嘗: ['害']
嘘: ['噓', '噱']
嘙: ['喓', '嚶', '嗖', '噯']
嘚: ['嚯', '嘌', '嚛']
嘜: ['啧', '嘷']
嘤: ['嘐', '喓', '嗳', '啰', '噮']
嘥: ['哌']
嘦: ['嫑']
嘧: ['嚐', '噛']
嘩: ['噿', '噑']
嘮: ['嗋', '嗗', '吻', '唷']
嘱: ['瞩']
嘲: ['咿', '嗍']
嘳: ['囋', '噒', '噹', '膭']
嘵: ['曉']
嘶: ['噺']
嘷: ['嘜', '噑', '暤']
嘹: ['嚓']
嘺: ['噶', '嚋']
嘻: ['噜', '嗋', '噆', '嚧']
嘽: ['嗶', '暺']
嘾: ['噥']
噁: ['哑']
噃: ['噌', '嚕']
噄: ['嘄']
噆: ['嗋']
噊: ['喘']
噋: ['啭', '嘋', '噭']
噌: ['噜', '噃', '啃', '嚕', '喒']
噍: ['礁', '嫶', '瞧']
噎: ['曀']
噏: ['嘃', '潝']
噑: ['嘩', '嘷', '暤']
噒: ['嘳', '暽', '噹']
噓: ['噱', '嘘']
噔: ['隥', '膯']
噖: ['噚']
噘: ['嚦']
噚: ['噖']
噛: ['嘧']
噜: ['喟', '噔', '嘻', '啃', '喧', '嚧', '噌', '唁', '嚕', '唷']
噞: ['哌']
噟: ['痦', '僐']
噡: ['谵']
噢: ['嗅', '嘸']
噣: ['噚', '喝']
噤: ['嘹']
噥: ['嘾', '嗆']
噦: ['咦']
噧: ['嗃']
噪: ['襙', '嘄', '哚', '嗛']
噫: ['噴', '啛', '嗃']
噬: ['啶']
噭: ['噋']
噮: ['嘤', '噿', '嗳']
噯: ['喓', '嗊', '嘙', '嗖', '喢']
噰: ['嗻']
噱: ['噓', '嘘']
噲: ['瞺', '徻']
噴: ['噫', '嘖']
噶: ['嘺', '嚿']
噹: ['嘳', '噒', '曥', '嘊']
噺: ['嚫', '嘶']
噿: ['嘐', '嘩', '啰', '噮']
嚀: ['濘', '擰', '矃', '嗐']
嚁: ['矐', '曤', '曜', '哑', '嬥']
嚄: ['矆']
嚅: ['懦', '隭', '嘕', '嘯']
嚉: ['襨']
嚋: ['嘺', '疇', '儔', '嘖', '嘯']
嚌: ['嚤', '嗜']
嚏: ['嚔']
嚐: ['嘧']
嚓: ['嘹']
嚔: ['嚏']
嚕: ['噜', '噃', '啨', '啃', '噌', '唁', '嘖', '嘯']
嚖: ['嘐', '嗡']
嚗: ['襮']
嚙: ['嚰']
嚚: ['鬀']
嚛: ['嗉', '嘌']
嚜: ['嚯', '暉']
嚝: ['嗉', '鳴', '嚾', '嗪']
嚞: ['霙', '藠', '熹']
嚢: ['橐', '蘘']
嚥: ['曣', '喙']
嚦: ['噘']
嚧: ['噜', '喊']
嚨: ['曨', '豅', '喻', '躘']
嚫: ['噺']
嚯: ['喗', '臛', '嗯', '嚜', '嘔', '嘌', '暉', '嘚']
嚰: ['嗆', '嗐']
嚱: ['嘁']
嚲: ['奲', '驒']
嚳: ['誉']
嚶: ['嘙']
嚺: ['曃']
嚽: ['嗼']
嚾: ['嚯', '嚝']
嚿: ['囋', '嗵', '噶', '嗎', '唈']
囁: ['攝']
囈: ['襼']
囉: ['曪', '喔']
囊: ['釁']
囋: ['嘳', '襸', '禶', '嚿']
囑: ['曯']
囗: ['冂', '口', '闩', '门']
囘: ['同']
囙: ['団', '回', '团', '叵']
囚: ['刃']
四: ['田', '冚']
囜: ['回', '团', '囙']
囝: ['団']
回: ['団', '囜', '团', '囙', '叵', '囬', '因']
因: ['団', '回']
囡: ['固', '囹', '囵']
团: ['団', '回', '囜', '囝', '囙', '因']
団: ['回', '囝', '囙', '因']
囤: ['圉', '国', '囩']
囥: ['囯', '囲']
囦: ['囷', '囹', '圛', '图', '團']
囨: ['圓', '囶']
囩: ['国', '囤', '園', '园']
囪: ['囱']
囬: ['回', '皿']
园: ['国', '囩', '囿', '囮']
囮: ['困', '园', '囿', '圊']
囯: ['囥', '囸']
困: ['圄', '圊', '囮']
囱: ['囪', '崮']
囲: ['囥', '囶']
図: ['阖']
囵: ['囡', '囸']
囶: ['囨', '圓', '囲']
囷: ['圈', '囦', '匿']
囸: ['囯', '囵']
囹: ['固', '囡']
固: ['囹']
囻: ['圆', '圂', '圑', '圍']
囼: ['圃', '圄']
国: ['囤', '囩', '園', '园']
图: ['圏', '國', '囹', '囦', '團']
囿: ['圁', '园', '圊', '囮']
圀: ['圆', '圂', '圍']
圁: ['圚', '圃', '訚', '园', '囿', '圊', '囮']
圂: ['圉', '圀', '圆', '图', '團', '圍', '圑', '囻']
圃: ['囼', '圚', '圁', '訚', '囿', '圊', '圇']
圄: ['圔', '困', '閭', '囼', '圚', '閭', '圊']
圆: ['圀', '園', '圂', '圑', '圍', '囻']
圇: ['圃', '圓']
圈: ['圝', '圏', '圞', '囷', '圜', '闇']
圉: ['阑', '国', '囤', '圂', '圑', '画', '囻']
圊: ['圔', '圚', '圃', '匨', '圁', '園', '圄', '囿', '囮']
國: ['圏', '囹', '圛', '闣', '匱', '圕', '图', '團']
圌: ['圍', '囻']
圍: ['圀', '圆', '圌', '圂', '圑', '囻']
圏: ['國', '囹', '圛', '圈', '圕', '图', '團']
圑: ['圉', '圆', '圂', '團', '圍', '囻']
園: ['圔', '阗', '国', '圆', '囩', '圊', '閻', '圖']
圓: ['囨', '圇', '囶']
圔: ['圚', '園', '圄', '圊', '圖']
圕: ['圏', '國', '囹', '圛', '匾', '圈', '闣', '匱', '囦']
圖: ['剾', '圔', '圆', '園', '囿']
團: ['圏', '國', '圛', '囦', '圂', '图', '圑']
圚: ['圔', '囼', '圃', '圁', '圄', '囿', '圊']
圛: ['圏', '國', '囹', '匾', '圕', '囦', '團']
圜: ['圝', '圞', '圈', '闄']
圝: ['鬮', '圞', '圜']
圞: ['圝', '圈', '爴', '圜']
土: ['亻']
圠: ['扎']
圡: ['乐']
圢: ['烣']
圤: ['拤']
圥: ['先', '兂']
圦: ['扏']
圧: ['厇', '叵']
圩: ['圲', '钎', '訏', '屽', '忏', '托', '扜', '柠', '圷']
圪: ['吃', '扢']
圭: ['峚', '圼']
圮: ['妃', '忋', '坧', '址']
圱: ['凡']
圲: ['钎', '屽', '忏', '托', '扜', '祍', '圩', '圷']
圴: ['抣', '彴', '扚', '均']
圵: ['坯', '壮', '社']
圶: ['全']
圷: ['圲', '忏', '圩']
圹: ['纩', '扩']
圻: ['祈']
圼: ['虽', '圭']
圾: ['极']
圿: ['岓', '杭', '枡']
址: ['扯', '坵', '垥', '坻', '坮', '粃', '圮']
坁: ['抵', '坻', '泜', '扺', '址', '坛']
坂: ['圾']
坅: ['垥', '忴']
坆: ['坎', '校', '忟']
均: ['抣', '圴', '约', '妁', '扚', '訋', '虳']
坈: ['屼']
坊: ['钫', '祊', '妨']
坋: ['份', '抍', '妢']
坎: ['抰', '坆']
坏: ['玕', '仟', '吓']
坑: ['抗', '牨', '柼']
坓: ['荎', '荚']
坕: ['玉']
块: ['抰', '妜']
坙: ['巠']
坛: ['坁', '坻']
坡: ['被', '垓', '垵', '詖', '狓']
坢: ['柈']
坥: ['狙', '抯']
坧: ['圮', '杻']
坨: ['咜', '忙', '伦', '岮']
坪: ['捋', '垀']
坫: ['柗', '岾']
坮: ['垥', '抬', '峆', '始', '绐', '拾', '址', '拾', '坅']
坯: ['征', '椌', '圵']
坰: ['垧', '垌']
坳: ['狕']
坴: ['茞']
坵: ['扯', '址', '拞']
坶: ['拇']
坷: ['何']
坹: ['坾', '袕']
坺: ['祓']
坻: ['抵', '坁', '扺', '址', '坛']
坼: ['拆']
坽: ['狑', '炩', '伶']
坾: ['坹', '仟']
垀: ['呯', '评', '坪']
垁: ['帙', '浃', '抶', '挾']
垂: ['蚕']
垄: ['莝']
垅: ['咙', '狵', '栊']
垇: ['埛']
垉: ['抱']
型: ['垔']
垌: ['垧', '坰', '埚']
垐: ['堏']
垓: ['埈', '咳', '垵', '坡']
垔: ['型']
垕: ['厔', '屋', '虗']
垗: ['珧', '咷']
垚: ['茾']
垛: ['哚']
垞: ['咤']
垟: ['烊']
垠: ['堁']
垡: ['堡']
垥: ['抬', '坮', '峆', '始', '绐', '拾', '址', '拾', '坅']
垧: ['坰']
垩: ['埾']
垪: ['拼']
垬: ['拱']
垮: ['堮', '绔', '搒']
垰: ['埰']
垳: ['裄', '哘', '衎']
垵: ['垓', '坡']
垶: ['埣']
垸: ['堄']
垺: ['俘']
垻: ['湨']
垾: ['晘']
埂: ['哽']
埇: ['捅', '鲬']
埈: ['垓', '埮']
埉: ['挟']
埋: ['塏']
埌: ['誏', '哴']
埍: ['捐']
埔: ['捕', '陠']
埕: ['锃', '浧']
埘: ['榭']
埙: ['埧', '堒', '塭']
埛: ['堋', '堈', '埫', '垇']
埞: ['碇']
埢: ['踡']
埣: ['垶', '晬', '埻']
埥: ['瑇', '摃', '塉', '搚']
埧: ['堒', '埙']
埨: ['棆', '陯', '惀']
埪: ['挖']
埫: ['埛']
埬: ['堜']
埭: ['殔', '堜']
埮: ['埈', '塽']
埰: ['堔', '垰']
埱: ['琡']
埲: ['樁']
埴: ['暄', '塇']
埶: ['執']
執: ['埶']
埸: ['塲']
培: ['塔']
基: ['荃', '寨']
埻: ['埣', '垮']
埼: ['堉', '婍', '裿']
埾: ['垩']
堁: ['垠', '猓']
堃: ['堏']
堄: ['垸']
堅: ['塱']
堈: ['埛']
堉: ['塉', '埼']
堋: ['掤', '埛']
堌: ['凅']
堍: ['堗']
堎: ['踜']
堏: ['堃']
堐: ['堽', '睚']
堒: ['埧', '埙', '塬', '塭']
堓: ['硸']
堔: ['琛', '埰', '墚']
堗: ['墺', '堍']
堘: ['塏']
堜: ['埬']
堞: ['揲', '喋']
堟: ['瑑', '猭']
堡: ['垡']
堤: ['提']
堥: ['蝥']
堬: ['喻', '揄']
堭: ['墔']
堮: ['垮']
堯: ['亮']
堵: ['琽']
堶: ['壻']
堷: ['腤']
堻: ['塣', '鎏', '壍']
堽: ['堐']
堿: ['椷', '减']
塁: ['烾']
塆: ['淯', '垨']
塇: ['埴']
塉: ['堉']
塌: ['搨', '褟', '禢']
塍: ['膛']
塏: ['埋', '堘']
塐: ['溸', '嗦', '壙', '墝', '慷']
塑: ['塱']
塔: ['撘']
塕: ['暡']
塗: ['墬']
塘: ['墻', '搪']
塙: ['缟', '皜', '禞', '擕', '境', '镐']
塚: ['塚']
塞: ['塞']
塢: ['墑', '摀', '鎢']
塣: ['堻']
塤: ['塿']
塥: ['嗝']
塧: ['搤', '墣']
塩: ['搕']
塪: ['掐']
填: ['壙', '瞋']
塬: ['堒']
塭: ['堒', '埙']
塮: ['謝']
塯: ['镏']
塰: ['壍']
塱: ['堅', '塑', '蜸', '墍']
塲: ['埸']
塳: ['璉', '墶', '摓']
塴: ['磞']
塵: ['庱', '摩']
塺: ['座']
塻: ['換']
塼: ['墰']
塽: ['埮']
塾: ['墪']
塿: ['塤', '墟']
墂: ['墠']
境: ['墇', '摬', '襓']
墇: ['撺', '憧', '境']
墉: ['槦', '檣', '慵']
墋: ['掺', '埗']
墌: ['摭', '墒']
墍: ['塱']
墑: ['塢']
墒: ['墌']
墓: ['董', '耋', '菙']
墔: ['堭']
墖: ['墙', '揜']
墙: ['樯', '墖']
墚: ['堔', '琛']
墝: ['塐', '壙']
增: ['缯']
墟: ['攎', '塿', '壉']
墠: ['墂']
墡: ['嫸']
墣: ['篌']
墦: ['嬏']
墧: ['墵']
墨: ['蠆', '璽']
墩: ['獤']
墪: ['塾']
墫: ['壿', '撙', '撏']
墬: ['鏧', '塗']
墰: ['镡', '贉', '憛', '塼', '谭', '曋']
墳: ['壖']
墴: ['獚', '曂']
墶: ['摓', '塳']
墷: ['璍']
墹: ['壛']
墺: ['換', '堗']
墻: ['塘']
墼: ['鏨']
墽: ['撴']
墾: ['璽', '琧']
壆: ['瞾', '罜']
壉: ['攎', '墟']
壊: ['壌']
壌: ['壊']
壎: ['櫵']
壏: ['襤']
壐: ['藌']
壒: ['瓂']
壔: ['燽']
壖: ['橘', '臑', '墳', '摴', '襦', '羺']
壘: ['壘']
壙: ['塐', '墝', '填']
壚: ['擄']
壛: ['墹', '擱']
壟: ['鎜', '鐾', '壟']
壠: ['豅']
壤: ['攘']
壦: ['瓘']
壨: ['蠪', '藋', '嚞', '蟿']
士: ['十']
壬: ['宁', '笁']
壭: ['贲']
壮: ['圵', '社']
壯: ['肚']
壶: ['壸']
壷: ['壸']
壸: ['壷', '壶']
壹: ['毒', '寚']
壻: ['揟', '堶', '糈']
壼: ['豊']
壽: ['夀', '馫']
壾: ['駏']
壿: ['撙', '墫', '撏']
夀: ['夁', '壽']
夁: ['賣', '夀']
处: ['沚']
夌: ['羑', '芰']
复: ['寛']
夏: ['戞']
夐: ['藑']
夑: ['爕']
夕: ['冫']
外: ['处']
夗: ['邜']
夙: ['凮', '屄']
夜: ['丧']
夣: ['褱']
夥: ['黟']
夫: ['夾', '夬']
夬: ['央', '宊', '夾', '夫']
央: ['宊', '夾', '夬']
夰: ['灮']
夲: ['來', '來']
夵: ['个']
夷: ['寔']
夹: ['爽']
夾: ['央', '夫', '夬']
奀: ['至']
奃: ['茊', '芪']
奈: ['奈']
奉: ['秦', '奏', '皐', '卓']
奍: ['亦']
奎: ['蝥']
奏: ['奠']
奐: ['耎']
契: ['契']
奒: ['变']
奕: ['穾', '奖', '実']
奖: ['奕', '桨', '穾']
奘: ['娤']
奜: ['猆', '棐']
奠: ['茣', '菒', '臭', '奏', '棄', '菓', '莫', '葽', '葜']
奤: ['啬', '嗇']
奥: ['荚', '袅']
奦: ['菐', '槖']
奨: ['奱']
奬: ['漿', '獎', '獘']
奱: ['孌', '奨', '卛', '欒']
奲: ['嚲']
奴: ['妅']
奵: ['矴', '妅', '灯']
奷: ['吁', '訐', '吀', '紆', '狅', '奼', '竏']
奸: ['妚', '讦', '纡']
奼: ['奷']
好: ['妅', '妵']
妁: ['抣', '约', '扚', '均', '虳']
如: ['妇']
妃: ['圮', '忋', '纪']
妄: ['娈', '妾']
妅: ['奵', '奴', '好']
妆: ['枚']
妇: ['如']
妉: ['妗']
妊: ['飪', '鈓', '岆']
妋: ['妜']
妌: ['姘']
妍: ['姸', '岍', '竔', '妬', '蚈', '咞']
妎: ['吤', '峅', '祄', '衸']
妏: ['奺', '纹', '姑']
妑: ['蚆', '鈀']
妓: ['姲', '姟']
妔: ['犺']
妗: ['怜', '拎', '妉']
妘: ['纭']
妚: ['柸', '奸']
妜: ['妋']
妝: ['肗']
妞: ['纽', '鈕']
妠: ['鈉']
妡: ['听', '岓', '折']
妢: ['帉', '坋']
妣: ['玭', '肶']
妥: ['叏', '乎']
妦: ['炸']
妧: ['姸']
妨: ['钫', '祊', '坊']
妪: ['婮', '娖', '婭']
妬: ['姸', '妍']
妮: ['鈮']
妵: ['好']
妶: ['挔', '妺', '妹', '婡']
妷: ['紩', '胅', '胦']
妸: ['胢', '砢', '跒']
妹: ['抺', '妺', '妶', '婡']
妺: ['婡', '妹']
妻: ['蒌', '蒆']
妾: ['娈', '麥']
姁: ['询', '妽']
姄: ['抿']
姅: ['秚', '姹', '蜉', '绊']
姈: ['岭']
姉: ['姹']
始: ['抬', '垥', '坮', '珆', '姶', '拾']
姌: ['娋', '柟']
姎: ['婒', '娩']
姏: ['鉗']
姐: ['爼', '姮']
姑: ['姡', '詁', '轱', '妏']
姒: ['鉯', '娰']
姓: ['﨡']
姘: ['賆', '妌']
姛: ['餇']
姝: ['株', '嫘']
姞: ['姹', '诘', '拮']
姟: ['核', '姲', '妓']
姠: ['饷', '銄']
姡: ['娝', '竡', '铦', '蛨']
姥: ['娃', '媎']
姦: ['轰']
姨: ['媓', '媋']
姩: ['哖']
姪: ['绖']
姭: ['婁']
姮: ['姐']
姰: ['竘', '徇', '絇']
姱: ['媎', '嫎', '銙']
姲: ['姟', '妓']
姵: ['嫗', '楓']
姶: ['冾', '抬', '始', '袷', '帢']
姸: ['銒', '竔', '妬', '妍', '蚈', '妧']
姹: ['姉', '姅', '姞']
姽: ['婏']
姾: ['辁', '妉']
姿: ['变']
威: ['烕', '咸']
娃: ['洼', '娮', '姥']
娆: ['挠']
娇: ['峤', '轿']
娈: ['妾', '妄']
娊: ['娓']
娋: ['姌', '绡', '峭', '捎']
娌: ['裡', '娙']
娍: ['嬂']
娎: ['椞']
娏: ['妭', '拢']
娐: ['捊']
娑: ['裟']
娒: ['婞', '挴']
娓: ['娊', '娷']
娔: ['挩']
娕: ['媡', '餗', '媇', '婡']
娖: ['妪', '捉']
娗: ['鋌', '艇']
娘: ['羪']
娙: ['娌', '媱']
娛: ['蜈']
娝: ['姡', '竡', '踎']
娠: ['陙', '婐', '桭']
娡: ['姯', '姟', '妓']
娣: ['銻']
娤: ['奘']
娥: ['硪', '睋']
娧: ['帨', '棁']
娨: ['皔']
娩: ['婏', '挽']
娮: ['娃', '唁']
娰: ['姒', '娵']
娱: ['婒', '洖']
娵: ['娰']
娷: ['棰', '睡']
娺: ['缀']
娻: ['媡']
娽: ['绿']
娿: ['嫈']
婃: ['婛', '棕', '嫽']
婄: ['嫆']
婆: ['嬃', '嫯', '嬜']
婈: ['祾']
婉: ['媿']
婊: ['嬢', '嫔']
婋: ['嬽']
婌: ['嬍', '椒']
婍: ['媂', '媗', '裿', '埼']
婎: ['脽']
婏: ['娩']
婐: ['腂', '娠']
婑: ['捼']
婒: ['娱']
婔: ['裶']
婕: ['媫', '媴']
婗: ['唲', '婉', '晲', '媿', '娩']
婚: ['殙', '緍']
婛: ['练', '捈', '媡', '嫽', '婃', '稤', '掠']
婜: ['嫳']
婝: ['锭']
婞: ['娒']
婟: ['綑']
婠: ['媘', '媗']
婡: ['妺', '妹', '妶', '娕', '棶']
婢: ['嬣']
婣: ['蜵', '孄']
婤: ['嫋', '媽', '禂']
婥: ['掉', '棹']
婦: ['掃']
婧: ['嫀', '精']
婨: ['婾', '掄']
婪: ['荌']
婫: ['绲']
婭: ['妪']
婮: ['妪', '娙', '据', '椐']
婯: ['嬖', '媭']
婱: ['媝', '荽']
婵: ['蝉']
婷: ['揨']
婸: ['媼', '鍚']
婹: ['嫂', '嫒']
婺: ['菨', '蒆', '荽']
婻: ['嬙']
婾: ['婨']
婿: ['嬒']
媁: ['嬈', '湋']
媂: ['婍', '缔']
媃: ['嫓', '楺']
媇: ['媡', '娕']
媉: ['媹', '楃', '嫟']
媋: ['暙', '姨']
媎: ['楮', '嫆', '褚', '姥', '姱']
媏: ['鍴', '揣']
媑: ['孀', '嬥']
媒: ['蹀', '楳']
媓: ['艎', '姨']
媔: ['栭']
媗: ['婍', '婠', '揎']
媘: ['婠']
媙: ['縬', '羬']
媛: ['嫒']
媜: ['嫃']
媝: ['婱']
媟: ['谍', '牃', '媣']
媠: ['婿', '焴']
媡: ['婛', '娻', '揀', '脨', '娕', '媇']
媣: ['媟']
媤: ['嫚']
媥: ['婛', '編', '鍽', '艑']
媦: ['緭']
媩: ['湖']
媪: ['媼']
媫: ['婕', '嫸']
媭: ['婯']
媮: ['榆', '娬', '鍮']
媯: ['偽', '溈']
媰: ['縐', '搊']
媱: ['娙']
媳: ['嫫']
媴: ['婕', '褤']
媵: ['腆', '螣']
媶: ['嬅']
媷: ['縟']
媸: ['皚']
媺: ['溦', '嫐', '嬓']
媼: ['婸', '膃', '縕', '媪']
媽: ['婤']
媾: ['嬑', '褠', '構', '煹', '溝', '嫱']
媿: ['婗', '婉', '餽']
嫀: ['殝', '獉', '嫝', '嫊']
嫁: ['鎵']
嫂: ['搜', '婹', '嬪']
嫃: ['媜', '禛']
嫆: ['婄', '媎', '绾']
嫇: ['媆']
嫈: ['榮', '娿']
嫊: ['塐', '溸', '嫀', '娻', '嫝', '嫬']
嫋: ['婤']
嫌: ['嬠', '賺', '槏']
嫍: ['熖']
嫎: ['膀', '搒', '姱']
嫏: ['鄉', '鄊']
嫐: ['媺', '嬓']
嫑: ['嘦', '孁']
嫒: ['蝯', '姯', '婹', '嬛', '媛']
嫓: ['嬝', '媃']
嫔: ['婊', '滨', '槟', '嫫']
嫖: ['嬥', '褾']
嫗: ['姵', '檛', '嫚']
嫘: ['姝', '螺']
嫙: ['椸']
嫚: ['嫗', '媤']
嫜: ['嶂', '暲', '樟']
嫝: ['孉', '嫀', '嫊', '嬐']
嫞: ['嬚']
嫟: ['媉']
嫢: ['嬃', '槼']
嫣: ['嫮']
嫤: ['谨', '嬞']
嫥: ['鏄', '嬄', '摶']
嫧: ['嬻', '掅', '皘', '嬄', '撌', '嬽']
嫩: ['隞', '撤']
嫫: ['嫔', '媳']
嫬: ['鏣', '嫊']
嫮: ['嶀', '嫣']
嫯: ['嬃', '婆', '嬜']
嫱: ['媾', '樯']
嫲: ['嬤']
嫳: ['婜', '娤']
嫵: ['膴']
嫶: ['撨', '噍']
嫸: ['媫', '嬙', '鳝', '饍', '墡']
嫹: ['婊', '嫫']
嫺: ['鐧', '孄', '嫻']
嫻: ['撊', '孄', '嫺']
嫼: ['潶']
嫽: ['婛', '鐐', '婃', '缭', '爒', '膫']
嫿: ['嬻']
嬀: ['撝']
嬁: ['竳', '澄']
嬂: ['娍', '膱', '職', '蟙']
嬃: ['嫢', '嫯', '婆']
嬄: ['嬌', '嬻', '撎', '饐', '嫧']
嬅: ['媶']
嬇: ['嬻', '蹪', '皟', '樻', '嬯']
嬈: ['鱙', '媁']
嬉: ['嬒', '礂', '蟢']
嬊: ['蔓']
嬌: ['燆', '嬄', '驕', '鐈']
嬏: ['襎', '墦', '燔', '橎']
嬐: ['鐱', '撿', '嫝']
嬑: ['臆']
嬒: ['鱠', '嬉', '婿', '摿']
嬓: ['媺', '嫐']
嬕: ['燡', '懌']
嬖: ['婯', '擘']
嬘: ['澻', '穟']
嬙: ['婻', '嫸']
嬛: ['嫒']
嬜: ['嫯', '婆']
嬞: ['孂', '嫤']
嬟: ['檥', '燨']
嬠: ['橾', '缲', '嫌', '鐰']
嬡: ['孆']
嬣: ['婢', '懧']
嬤: ['孂', '嫲']
嬥: ['嫖', '孍', '蠷', '媑']
嬦: ['濤', '禱']
嬧: ['濜']
嬩: ['嬹', '懙']
嬪: ['臏', '嫂']
嬬: ['嬻', '臑', '曘', '燸', '襦']
嬮: ['魘']
嬯: ['嬇']
嬱: ['孁']
嬳: ['艧', '擭']
嬴: ['赢', '贏', '臝', '鸁', '蠃', '驘']
嬹: ['嬩', '懙']
嬻: ['嬇', '嬄', '嫧', '嫿']
嬽: ['婋', '嫧']
孀: ['媑']
孁: ['嬱', '嫑', '蘡', '霎']
孂: ['嬤']
孃: ['躟', '瀼', '欀']
孄: ['婣', '斕', '嫻', '嫺']
孅: ['懺', '櫼']
孆: ['嬡']
孉: ['嫝', '爟']
孊: ['攠']
孋: ['躧']
孌: ['奱', '攣', '欒']
孍: ['嬥']
孏: ['钄']
孕: ['氒', '牟']
孛: ['辛', '李']
孝: ['莩', '率']
孡: ['珨', '跆', '秮', '眙']
季: ['秊', '荸', '乖', '秊']
学: ['竿']
孩: ['骇']
孪: ['斈', '荸', '率', '蛮', '李', '率']
孭: ['珼']
孱: ['愿']
孲: ['錏']
孳: ['摮', '窙', '革', '荜']
孶: ['藝', '薴']
孷: ['氂']
學: ['雽']
孹: ['擘', '繴']
孼: ['蠥', '犨']
孿: ['蠻']
宀: ['寽']
宁: ['壬']
宂: ['冗', '夰', '丆', '它']
它: ['宂', '丆']
宄: ['冗', '刋', '氕', '宍']
宅: ['宅']
宇: ['宷', '朿', '亰']
守: ['矴']
宊: ['宩', '央', '夬']
宋: ['宙']
宍: ['氕']
宎: ['穼', '突']
官: ['営']
宙: ['宋']
実: ['筙', '奕', '穾']
宥: ['肓']
宨: ['宪']
宩: ['宊']
宪: ['宨', '克']
宫: ['容', '舎', '吝']
宰: ['寔', '耒']
宲: ['寀']
害: ['嘗']
宴: ['蓃']
宵: ['胃']
宷: ['朿', '宇', '束', '突', '箂']
宸: ['瘸']
容: ['宫']
寀: ['桨', '宲', '穾', '柰', '棨', '穻']
寊: ['霣', '貿']
富: ['寛', '复', '啬']
寔: ['宰', '夷', '畗']
寗: ['髯']
寘: ['賈', '賈', '賷', '貪']
寚: ['壹', '毒']
寛: ['复', '富']
寠: ['簍']
實: ['窗']
寧: ['事', '牽', '窼', '挚']
寨: ['基', '案']
寮: ['寮']
寰: ['賽']
寳: ['寶']
寶: ['寳', '賮']
寷: ['靈', '薋', '霻', '靈']
寻: ['杲']
尅: ['鬽']
尉: ['胕']
小: ['丄']
尓: ['仆']
尗: ['志', '永']
尘: ['生']
尚: ['峝']
尝: ['昗']
尢: ['犬']
尣: ['兑', '允', '兄', '灮', '兊', '亅']
尤: ['冘']
尩: ['尫']
尫: ['尩']
尰: ['揰']
尸: ['乛', '厂']
尺: ['曰', '汛']
尼: ['且', '巨']
尾: ['厮']
尿: ['杘', '尿']
局: ['周']
屃: ['损']
屄: ['凮', '夙']
居: ['涺']
屆: ['屉', '届']
屉: ['届', '屆']
届: ['屉', '屆', '屌']
屋: ['厜', '屐', '屍']
屌: ['屑', '届']
屍: ['屐', '屋']
屐: ['屍', '屋']
屑: ['屌']
屓: ['厣']
展: ['屡', '辰']
屖: ['屝']
屝: ['屖']
属: ['屬']
屟: ['屧']
屡: ['展']
屢: ['屢']
履: ['愿', '履']
屦: ['屨']
屧: ['屟']
屨: ['屦']
屬: ['属']
屮: ['丫']
屯: ['市', '中', '杏']
山: ['冚']
屳: ['仚']
屴: ['労']
屵: ['户']
屷: ['釢', '屾']
屹: ['岣', '紇']
屺: ['紀']
屻: ['軔']
屼: ['炌', '坈']
屽: ['圲', '钎', '秆', '豻', '扞', '忏', '扜', '圩']
屾: ['岶', '岮', '吣']
岀: ['出']
岄: ['岨', '柤', '枳', '岠']
岆: ['岍', '妊', '訞']
岈: ['蚜', '崡']
岉: ['岣', '峋']
岋: ['级', '皈']
岍: ['竔', '妍', '蚈', '咞']
岎: ['紛']
岏: ['炘']
岐: ['岟', '蚑', '帓', '峡', '峖', '汥']
岑: ['笒', '岺', '笭']
岒: ['妗', '軡']
岓: ['听', '紤', '折', '妡', '訢']
岕: ['乔']
岘: ['蛌', '崐']
岜: ['亩']
岝: ['単', '崒', '苲']
岟: ['岐', '蛺', '嶦', '峖']
岠: ['岄', '岨', '壾', '岴', '秬', '帊', '柤']
岡: ['罔']
岣: ['峋', '岉']
岤: ['岶', '蚢']
岨: ['岄', '跙', '秬', '柤', '岠']
岫: ['峆', '峪']
岬: ['鈟']
岭: ['峥', '嵺', '姈']
岮: ['纶', '岶', '坨', '蛇', '鉈']
岯: ['怌', '紑']
岲: ['軦', '岴']
岴: ['岲', '帊', '岠']
岵: ['怙', '祜', '鮕', '帢']
岶: ['屾', '岹', '岮', '粕']
岹: ['岶', '銆', '蛨']
岺: ['岑']
岻: ['毗']
岽: ['炭']
岾: ['衽', '坫', '牯']
峃: ['仚']
峄: ['怿', '崡']
峅: ['帨', '妎', '皏', '峡']
峆: ['垥', '坮', '峪', '崯', '岶', '绐', '拾', '拾', '岫']
峈: ['饹', '峔', '衉']
峋: ['岣', '岉']
峍: ['幥', '蛼']
峐: ['帔', '峻', '峖']
峒: ['崛', '嵋', '崐', '嵶']
峓: ['崎', '蛦']
峔: ['嵦', '峈']
峕: ['旹']
峖: ['岟', '帔', '岐', '峐', '蚑', '峻']
峗: ['崅']
峙: ['帹']
峚: ['圭']
峝: ['尚']
峡: ['岟', '岐', '峅', '峐', '崃', '蛱']
峤: ['轿', '娇']
峥: ['崥', '岭']
峪: ['唂', '峆', '輍', '岫']
峫: ['椰', '嵺', '嶵']
峬: ['峭', '巁', '秿', '蛸']
峭: ['绡', '娋', '梢', '峬', '蜅']
峮: ['峿', '崏']
峰: ['蛑', '峂', '桻']
峳: ['嶔']
峴: ['蜫']
峷: ['丵']
峺: ['崸']
峻: ['峐', '蜲', '蝼', '峖']
峽: ['陜', '唊', '陝']
峿: ['峮', '啎', '牾']
崃: ['崠', '嶛']
崅: ['螐', '峗']
崉: ['嵣', '嶙', '螗', '崨']
崊: ['綝']
崌: ['艍', '崏']
崍: ['岟', '蛺']
崎: ['蛼', '嶗', '畸', '峓', '犄']
崏: ['惛']
崐: ['岘', '崛', '峒', '蚍', '煨', '崸']
崒: ['罦']
崕: ['崛']
崘: ['蜦']
崙: ['崙']
崚: ['帻', '輘', '糉']
崛: ['峒', '嵋', '崕', '崐']
崝: ['蜻', '皘', '嶹', '蝳', '嵴']
崞: ['焞', '崥', '蟀', '嵉']
崠: ['嵣', '嶛', '嶸', '崃']
崡: ['峄']
崢: ['皔']
崣: ['霎', '窭']
崤: ['螖']
崥: ['嵃', '峥', '蟀', '粺', '崞']
崦: ['崹']
崨: ['蜨', '嵣', '螗', '崠', '崉', '蜯']
崪: ['脺']
崬: ['嶚']
崮: ['囱']
崯: ['崲']
崱: ['勛']
崲: ['崯']
崳: ['偷', '蝓', '輸']
崷: ['煪']
崸: ['煩', '峺', '煨']
崹: ['嵃', '崦']
崽: ['悘']
崾: ['巊', '嵈', '嵶']
崿: ['愕']
嵃: ['崥', '幒', '嵼', '崹']
嵄: ['嶸']
嵅: ['嵗']
嵈: ['嵕', '崾', '嶁', '嶾']
嵉: ['幥', '嶧', '婷', '崞', '楟', '蜳']
嵋: ['崛', '峒', '嵶']
嵐: ['嵐']
嵑: ['輵', '嵎', '鞨']
嵒: ['喦']
嵕: ['嵈']
嵗: ['嵅']
嵘: ['蜍']
嵢: ['崉', '艙']
嵣: ['蜨', '螗', '崠', '崨', '崉', '蝷']
嵧: ['嶱']
嵨: ['蟡']
嵪: ['嵻', '熇']
嵭: ['鳑', '螃']
嵮: ['嶛', '槙']
嵲: ['嵻', '槕']
嵴: ['崝', '蝳']
嵶: ['崾', '峒', '嵋']
嵺: ['峫', '熮', '岭']
嵻: ['嵲', '嵪']
嵽: ['螮']
嵾: ['栆']
嵿: ['薠']
嶀: ['嫮', '摴', '幘', '嶿']
嶁: ['嵕', '崾', '嵈']
嶂: ['幥', '暲', '嶢', '樟', '犝', '嫜', '蟑', '巆']
嶄: ['崭']
嶆: ['艚', '糟', '鏪']
嶋: ['鳰', '鵭', '樢', '鵴', '鴘', '鴆', '鳭', '鴗', '鳩']
嶍: ['嵕', '蝔']
嶐: ['窿']
嶑: ['蟓']
嶒: ['崠']
嶓: ['鱕', '襎', '燔', '幡', '橎']
嶔: ['峳']
嶕: ['蟭']
嶗: ['崎', '蟧']
嶙: ['崉']
嶚: ['崬']
嶛: ['嶢', '崠', '嵮', '崃']
嶜: ['嵩']
嶞: ['嶨']
嶟: ['蟮', '樽']
嶠: ['鱎', '燆', '櫔']
嶢: ['蟯', '嶂', '嶛']
嶦: ['蟘', '岟']
嶧: ['煇']
嶨: ['嶞']
嶩: ['幨', '嶸', '愓', '峖']
嶪: ['窼']
嶬: ['巏']
嶱: ['嵧']
嶳: ['鑫']
嶵: ['峫']
嶸: ['嶩', '爃']
嶹: ['醻', '崝', '燽']
嶾: ['巑', '嵈']
嶿: ['蟰', '襦', '幘', '鱬']
巁: ['峬']
巃: ['竉']
巄: ['隴', '櫳']
巅: ['巔', '巓']
巆: ['嶂', '嶛']
巏: ['嶬']
巑: ['嶾']
巓: ['巅', '巔']
巔: ['巅', '巓']
巖: ['鳳']
巙: ['犪']
巟: ['沅', '示']
巠: ['坙']
巡: ['迯']
巢: ['楶']
巣: ['桑', '梟']
工: ['匚', '彐', '丅', '丁', '汒']
左: ['庄']
巨: ['尼', '目', '且', '佢']
巯: ['疏']
已: ['巴']
巴: ['円', '巳', '已']
巵: ['卮']
巾: ['由']
帀: ['襾']
币: ['市']
市: ['击', '币']
帄: ['叮', '朾', '忊']
帅: ['师']
师: ['帅']
帉: ['妢']
帊: ['岴', '蚔', '紦', '岠']
帏: ['纬']
帓: ['蛷', '岐', '粖']
帔: ['峐', '峖']
帕: ['枱']
帖: ['袩']
帙: ['垁', '楰']
帜: ['帨', '帺']
帝: ['帟']
帟: ['帝']
帡: ['軿', '鉼', '硑', '餅']
帢: ['粭', '姶', '袷', '岵', '枪']
帣: ['罨']
帥: ['纯']
帧: ['帻']
帨: ['峅', '帜', '娧']
帩: ['輎', '幘']
帪: ['帿']
帱: ['鋳', '椿']
帲: ['姘']
帴: ['俴']
帵: ['幏', '惋', '焥']
帹: ['﨑', '峙']
帻: ['崚', '帧']
帼: ['岖']
帽: ['幝']
帾: ['鯺']
帿: ['糇', '帪']
幀: ['幒', '棹']
幃: ['愇', '椲']
幅: ['惺']
幈: ['幙']
幋: ['幣']
幏: ['幒', '帵']
幑: ['黴']
幒: ['嵃', '幏', '幀']
幓: ['幥', '糝', '幟', '犙']
幕: ['暮']
幖: ['幰']
幗: ['恇', '幁']
幘: ['嶀', '墳', '帩', '幩', '皟', '燌', '樻', '嶿']
幝: ['熚', '帽']
幡: ['嶓']
幢: ['幩', '燑']
幣: ['幋']
幥: ['幓', '樟', '嵉', '峍']
幨: ['嶩']
幩: ['櫝', '羵', '幘', '幢']
幬: ['鑄', '檮', '擣']
幰: ['幖']
幱: ['欗']
干: ['于']
平: ['茪']
年: ['年']
幵: ['丂', '丌', '歼', '升']
并: ['汴', '井']
幷: ['井']
幻: ['汈']
广: ['仁', '辶', '乀', '厃', '丆', '勹', '匸']
庀: ['疕', '庎']
広: ['应']
庄: ['左', '戍']
庅: ['庒']
庇: ['庍', '茈']
庈: ['庝']
庌: ['庝', '戽', '庯']
庎: ['庀']
庒: ['庅']
库: ['底']
应: ['広']
底: ['库']
庝: ['庈', '庌']
庠: ['康']
庤: ['岸']
庥: ['庪']
度: ['度']
座: ['塺']
庪: ['庼', '庥']
庯: ['管', '庌']
庲: ['廉', '庺']
庳: ['瘣', '痺']
庴: ['瘖', '傄']
庵: ['痷']
康: ['庼']
庸: ['腐']
庼: ['康', '庪']
廁: ['廊']
廄: ['廕', '廘']
廅: ['座', '篚']
廈: ['廋']
廉: ['廉']
廊: ['廁', '廍']
廋: ['瘿', '廈']
廍: ['廊']
廓: ['廓']
廕: ['廯', '廫', '廄']
廗: ['唐', '磨']
廘: ['廫', '廄']
廙: ['瘼']
廛: ['麙', '甅', '麞', '麈', '螷']
廝: ['廊']
廟: ['廓']
廣: ['魔', '黀']
廤: ['蜃', '厪']
廥: ['庸']
廧: ['靥', '麏']
廨: ['廯', '廫']
廩: ['廪', '鏖', '鷢', '癝', '蠯', '癛', '虞', '麋']
廪: ['廩', '麎', '鏖', '麖', '鷹', '麇', '蠯']
廫: ['廭', '廕', '廘', '廨']
廬: ['麠', '廲', '鷹', '廬']
廯: ['廨', '廕', '癬']
廲: ['麙', '廬', '廬']
延: ['廷']
廷: ['延']
廻: ['迡']
异: ['舁']
弃: ['竎']
弄: ['弄', '羿', '竎']
弍: ['戌']
弑: ['弒']
弒: ['弑']
弓: ['吞']
弞: ['钦']
弶: ['猄']
弹: ['弾', '啴']
弽: ['喋']
弾: ['弹']
彃: ['彈']
彈: ['彃']
彍: ['獷']
彎: ['矕']
彐: ['匚', '日', '归', '工', '凹', '汅']
归: ['彐', '凹']
彗: ['莙']
彙: ['蒖']
彛: ['彜', '彞']
彜: ['葬', '彞', '彛']
彞: ['彜', '彝']
彤: ['涁', '卍']
彨: ['彫']
彫: ['彨']
彳: ['纟', '氵']
彴: ['抣', '圴']
彵: ['他']
彷: ['柼']
彺: ['杠', '忹', '呸', '狂']
往: ['估', '徭']
征: ['坯']
徂: ['拒', '恆']
徃: ['拦']
径: ['陉', '羟']
待: ['持']
徇: ['绚', '姰']
徉: ['详']
徊: ['悃', '佪']
律: ['律']
後: ['倰']
徍: ['佳']
徑: ['俓', '桱']
徒: ['掟']
徔: ['泛']
徘: ['悱']
徚: ['栜', '倲']
徛: ['倚', '渏']
徝: ['槒', '慉']
徟: ['倜']
徠: ['淶']
徣: ['偣']
徥: ['檚']
徧: ['斒']
復: ['復', '徺']
徫: ['憶']
徬: ['袴', '挎']
徭: ['滛', '傜']
微: ['倣', '鰴']
徰: ['偎']
徱: ['漂']
徶: ['慠', '徾']
德: ['祷', '梼']
徸: ['逳', '犝', '穜']
徹: ['澈']
徻: ['儈']
徼: ['擞']
徽: ['澂']
徾: ['徶']
忁: ['摱']
忂: ['濯']
忄: ['礻', '饣']
忆: ['怔', '忙']
忇: ['扐']
忈: ['忐']
忉: ['初', '朷']
忊: ['帄', '杠', '打', '忹', '忖']
忋: ['妃', '抎', '圮']
忌: ['岊']
忏: ['圲', '钎', '抔', '屽', '托', '扜', '祍', '圩', '柠', '圷', '拧', '枖']
忐: ['忈']
忓: ['钎', '扦', '抔', '扞', '拧']
忔: ['怆', '佗', '犵']
忕: ['杕']
忖: ['抃', '忊']
忙: ['伦', '怭', '忆', '拄', '坨']
忚: ['牠', '恄', '怴']
忛: ['伢']
忟: ['玫', '忱', '坆']
忡: ['牪']
忤: ['忺']
忦: ['朹', '炘', '扴']
忩: ['忽', '怱']
快: ['怏', '恔']
忬: ['妤', '怦']
忭: ['怀']
忮: ['怯']
忯: ['诋', '饪', '低']
忰: ['怑']
忱: ['怙', '忟']
忲: ['汏']
忳: ['怍']
忴: ['衿', '坅']
忹: ['枟', '灹', '杠', '彺', '仟', '忊']
忺: ['吹', '忤', '怍']
忻: ['炘']
忼: ['吭', '粒', '访', '拉', '袕']
忽: ['怱', '忩']
怀: ['忭']
怆: ['炲', '怜', '忔', '恰', '烚', '佮']
怇: ['讵', '诅', '仾', '怩']
怉: ['怡']
怊: ['祒']
怋: ['恆', '把', '佤']
怌: ['伓', '岯']
怍: ['忳', '秨', '拃', '忺', '饬', '佇']
怏: ['快', '悾']
怐: ['洵']
怑: ['炐', '忰', '伴', '拌']
怒: ['怒']
怓: ['伮']
怔: ['任', '忆', '茌']
怕: ['枦']
怗: ['钻']
怙: ['忱', '炶', '祜', '岵']
怚: ['伹', '沮', '怪']
怛: ['泹', '但']
怜: ['妗', '怆', '怜']
怡: ['炲', '怉', '恰', '治', '诒']
怢: ['仵']
怦: ['忬']
性: ['烂']
怨: ['恁']
怩: ['怇']
怪: ['怚', '恎']
怬: ['伵']
怭: ['忙', '抋']
怯: ['忮']
怰: ['悏']
怱: ['忽', '忩']
怴: ['忚']
怹: ['憋']
怾: ['炾']
怿: ['峄']
恀: ['蛥', '犙']
恁: ['怨']
恂: ['恦', '拘', '询', '姁']
恃: ['侍']
恄: ['饴', '悾']
恆: ['侸', '怋', '徂']
恇: ['悭', '悝', '幗', '悂']
恈: ['悝', '悍', '洠', '榉']
恉: ['诣']
恊: ['協']
恍: ['侊']
恎: ['迀']
恏: ['怒']
恐: ['恧']
恑: ['佹']
恒: ['悦']
恓: ['洒']
恔: ['恠', '怏', '快', '佼', '炆', '悾']
恖: ['惌']
恗: ['涄', '袴']
恜: ['试']
恠: ['恔', '伉']
恢: ['侅']
恥: ['毦']
恦: ['恂']
恧: ['恐']
恨: ['悞', '愠', '惯', '愄', '佷']
恫: ['诇', '惘', '榈']
恬: ['佸']
恮: ['侄', '仕', '烇']
息: ['慈']
恰: ['怆', '炲', '估', '怡', '烚', '佮', '铪']
恱: ['涗']
恴: ['意']
恵: ['窗', '悥', '悤']
恷: ['烋']
恹: ['愜']
恺: ['俉']
恻: ['懰', '憪', '侀']
恼: ['惂']
恿: ['愚']
悀: ['愊']
悂: ['恇', '悭']
悃: ['個', '佪', '焑', '徊']
悄: ['悑']
悇: ['蜍', '悰']
悈: ['惐']
悋: ['洛', '佫', '洛']
悍: ['愑', '惺', '恈', '捍']
悎: ['倠', '牿']
悏: ['怰', '饺', '泱', '佚']
悑: ['悄']
悕: ['烯']
悘: ['崽']
悙: ['涥', '传']
悚: ['愱', '惊']
悛: ['惾']
悝: ['恇', '悭', '俚']
悞: ['愥', '惾', '惯', '恨']
悟: ['侢', '居']
悡: ['憋']
悢: ['烺', '愧']
悤: ['恵']
悥: ['恵']
悦: ['恒', '忪']
悪: ['惡', '惡']
悭: ['恇', '俚', '悝', '悂']
悮: ['熀', '愪', '愰']
悯: ['個', '泂']
悰: ['憭', '悇']
悱: ['徘']
悴: ['忰', '祽', '捽']
悵: ['惿', '倀']
悶: ['焛']
悹: ['覚']
悺: ['倌']
悼: ['焯', '惮']
悽: ['棲', '愭']
悾: ['恄', '怏']
惀: ['埨', '棆', '淪']
惂: ['恼', '谄']
惃: ['愜', '倱', '焜']
惄: ['怒']
情: ['傮', '愭', '请']
惇: ['焞', '揨', '俜', '朜']
惊: ['涼', '榢', '悚']
惋: ['帵', '焥']
惌: ['恖']
惐: ['悈']
惓: ['倦']
惔: ['愤', '侅', '倐']
惘: ['诇', '焵', '恫']
惙: ['懾', '惿']
惛: ['愩', '崏']
惜: ['渞']
惡: ['悪', '惡']
惨: ['懩']
惬: ['慪', '搄', '逦']
惮: ['悼', '焯', '悕']
惯: ['悞', '惾', '儥', '慣', '恨']
惰: ['憧', '堶', '清', '懜', '憓']
惱: ['傴']
惲: ['渾', '懼', '憚', '禈']
惶: ['愃', '倬']
惹: ['蕸']
惺: ['慳', '湢', '憆', '幅']
惻: ['侧', '測', '側']
惽: ['愪', '憣', '穞', '儅']
惾: ['悞', '侵', '悛', '憀', '慺', '惯', '椶', '梫']
惿: ['憷', '惙', '悵', '愝', '偍', '偃', '煶']
愀: ['煍']
愃: ['犆', '惶', '蝖', '愘', '傄', '控']
愄: ['恨']
愅: ['煂', '愺']
愇: ['憧', '鞗', '幃', '褘', '憓']
愊: ['悀']
愍: ['憗', '慗', '愳']
愎: ['慢', '椱']
意: ['恴']
愐: ['偭']
愑: ['湧', '愩', '悍']
愒: ['谒']
愓: ['嶩']
愔: ['涾', '湆', '偣', '愹', '楏']
愕: ['堮', '崿']
愖: ['愠']
愘: ['愃', '疼', '偣', '愹', '楁']
愚: ['恿']
愜: ['恹', '愢', '惃']
愝: ['惿', '熰', '櫃', '慪', '悵', '榧', '愼', '爏', '偃', '樞']
愞: ['懊']
愠: ['愖', '恨']
愢: ['愜']
愣: ['楞']
愤: ['惔', '懊']
愥: ['悞', '煐']
愧: ['懊', '傀', '俍', '悢']
愩: ['愑', '惛', '楎', '烦']
愪: ['悮', '惽', '熉', '愼']
愫: ['傃', '懭']
愭: ['橦', '螧', '漕', '櫅', '悽', '情', '傮', '櫿']
愮: ['俓']
愯: ['煷', '儁', '槜', '懏', '慺']
愰: ['悮', '熀']
愱: ['悚']
愲: ['憎']
愳: ['厯']
愴: ['嗆']
愶: ['慻', '債']
愷: ['慅']
愹: ['焙', '熔', '愔', '溶', '穃']
愺: ['愅', '憁']
愼: ['儨', '慪', '愪', '懫', '慣']
愽: ['燇', '馎', '博']
愾: ['憬']
愿: ['蜃', '厪', '孱', '履', '履']
慀: ['徯']
慄: ['憟', '慄']
慅: ['慳', '愷']
慈: ['葸']
慉: ['櫁', '槒', '儐', '徝', '慎']
慌: ['僸', '懩', '懴']
慎: ['掉', '愤', '慉', '湞']
慏: ['偄', '懙']
慒: ['螬', '捿', '撯', '撞', '搘']
慕: ['募']
慗: ['愍', '憗']
慘: ['鰺']
慛: ['憆']
慜: ['慾']
慞: ['傹', '懌']
慟: ['働']
慠: ['徶']
慡: ['憶']
慢: ['熳', '懼', '愎']
慣: ['憯', '儨', '櫍', '儥', '愼', '懫', '慺', '惯']
慥: ['糙']
慧: ['萭']
慪: ['愝', '愼', '惬', '爏', '偃', '樞', '慣']
慬: ['僡', '憶', '爅']
慯: ['槗']
慱: ['懵', '竱']
慳: ['慅']
慵: ['槦', '瘺', '墉']
慷: ['塐', '爌']
慺: ['債', '惾', '懫', '愯', '惯', '慣', '螻']
慻: ['愶']
慾: ['慜']
憀: ['惾', '僇']
憁: ['傯', '樬', '熜', '愺']
憅: ['懃']
憆: ['慛', '惺']
憈: ['憺']
憋: ['怹', '悡']
憍: ['犞']
憎: ['愲']
憐: ['憐']
憑: ['凴']
憒: ['愶']
憓: ['撺', '憧', '憽', '憭', '愇', '僮', '懡']
憔: ['僬', '憮']
憗: ['愍', '慗']
憘: ['懂', '熺', '蟢']
憚: ['惲', '嬋']
憛: ['瞫', '镡', '僼', '贉', '燂', '墰', '價', '谭', '曋']
憜: ['懏']
憝: ['懯']
憟: ['樮', '慄', '慄']
憢: ['僥']
憣: ['惽', '儅', '僠']
憤: ['憧']
憦: ['朥']
憧: ['惰', '撺', '憤', '憶', '墇', '愇', '僮', '懡', '箯', '憓']
憪: ['櫩', '恻']
憫: ['倗']
憬: ['愾']
憭: ['撺', '悰']
憮: ['憔']
憯: ['僭', '慣', '熸']
憲: ['齌']
憳: ['傅', '溥']
憶: ['僡', '慡', '摬', '煒', '徫', '熩', '燷']
憷: ['惿']
憺: ['憈', '膽']
憽: ['懐', '懡', '憓']
懀: ['慻', '熦', '捨', '膾']
懁: ['鱞', '儥', '價', '馉']
懂: ['煄', '檟', '懻']
懃: ['憅']
懅: ['濾', '濾', '攄']
懊: ['债', '愤', '惔', '愞', '燠', '愧']
懌: ['釋', '嬕', '慞']
懎: ['懱']
懏: ['儁', '憜']
懐: ['懱']
懙: ['嬩', '嬹', '慏']
懚: ['儇', '僓']
懛: ['膻']
懜: ['惰', '憧']
懝: ['儗']
懠: ['臍', '倩', '隮']
懡: ['憽', '櫥', '憓']
懢: ['濫']
懤: ['隯']
懥: ['懳', '摃']
懦: ['嚅']
懧: ['嬣', '縡', '憁', '儜']
懩: ['慌', '懴']
懫: ['債', '儨', '慪', '櫍', '惧', '愼', '慺', '慣']
懭: ['愫', '犥', '矌']
懯: ['憝']
懰: ['恻']
懱: ['懐']
懴: ['懩', '懺', '慌', '殲', '僙']
懵: ['撎', '慱', '搢']
懶: ['懶']
懺: ['懴', '孅']
懼: ['燿', '慢', '臞', '爠']
懽: ['瀖', '攚', '權', '爜']
懾: ['惙']
戀: ['戀']
戌: ['弍']
戍: ['庄', '戎']
戎: ['戍']
成: ['戒']
戒: ['成']
戛: ['蔓']
戝: ['贱']
戞: ['夏']
戢: ['哉']
戩: ['戬']
戫: ['鍼']
戬: ['戩']
戮: ['戮']
戯: ['戱']
戰: ['戣']
戱: ['戯']
戲: ['獻']
户: ['屵', '凢', '卋']
戹: ['茩', '扂']
戽: ['庌']
所: ['斦']
扁: ['扂']
扂: ['戹', '扁']
扃: ['扄']
扄: ['扃']
扈: ['腐']
扉: ['雇']
手: ['苧']
扎: ['圠', '払', '扖', '扚']
扏: ['栻', '抌', '拱', '圦']
扐: ['忇']
扑: ['杺', '牝', '朲', '抃', '扥']
扒: ['执', '払', '玐', '扖', '択', '扟', '扸', '抭']
打: ['忊', '杌']
扔: ['扚', '抇']
払: ['扖', '扒', '狖', '扎']
扖: ['执', '払', '扒', '択', '扎']
扗: ['栝', '柸', '抂', '拉', '扛', '抆']
托: ['圲', '杍', '枉', '抔', '忏', '扜', '祍', '圩', '枖']
扙: ['扶', '扠']
扚: ['圴', '妁', '扔', '均', '扎']
扛: ['抂', '衽', '扗']
扜: ['圲', '钎', '抔', '屽', '扞', '虶', '忏', '托', '祍', '圩', '柠', '拧', '枖']
扞: ['圲', '钎', '秆', '杍', '枉', '抔', '屽', '忓', '托', '扜', '拧']
扟: ['扭', '扒']
扡: ['挹', '阤']
扢: ['圪', '抭']
扣: ['扫']
扥: ['牦', '抌', '扑']
扦: ['犴', '籷', '忓', '杅', '杯']
执: ['捝', '扖', '扒', '拼', '抭']
扨: ['切']
扩: ['纩', '抄', '拡', '圹']
扫: ['扣']
扭: ['钮', '扟']
扮: ['枌', '扴']
扯: ['抵', '坵', '桩', '址', '拞']
扲: ['抃']
扴: ['抡', '枔', '拉', '桥', '朹', '抗', '抍', '抏', '忦', '柼']
扶: ['扙', '抉', '拄', '衴']
扷: ['祅', '袄']
扸: ['扒']
批: ['讹', '阰']
扺: ['抵', '扯', '坁', '坻']
扻: ['杴', '拉']
扽: ['吨']
找: ['枚']
技: ['捁', '抩']
抁: ['挢', '抢']
抂: ['扛', '衽', '扗']
抃: ['扲', '柱', '忖', '扑', '杧']
抄: ['拃', '扩']
抆: ['牧', '拉', '扗', '柆']
抇: ['扔']
抉: ['扶', '抰', '決']
把: ['怋']
抋: ['怭']
抌: ['扏', '抚', '扥']
抍: ['份', '朹', '坋']
抎: ['忋']
抏: ['扴']
抐: ['抽']
抒: ['抸']
抓: ['拡']
抔: ['杍', '枉', '忓', '扞', '狉', '忏', '托', '扜']
抗: ['坑', '扴', '牨', '柼']
折: ['岓', '板', '妡']
抙: ['拄', '括', '拯']
抚: ['抌', '柉']
抛: ['拋']
抜: ['披', '拔']
択: ['扖', '扒']
抡: ['拉', '扴']
抢: ['抁', '拴', '拾', '拾']
抣: ['圴', '约', '彴', '妁', '均', '虳']
报: ['摂']
抦: ['拪']
抧: ['抲']
抩: ['袡', '抪', '捁', '技', '桝']
抪: ['抩']
披: ['拔']
抬: ['冾', '梒', '垥', '坮', '珆', '姶', '始', '绐', '拞', '拾']
抭: ['执', '扒', '炕', '扢', '狖']
抯: ['坥', '狙', '拒', '炟']
抰: ['柍', '坎', '校', '块', '抉', '挍']
抱: ['拖', '垉']
抲: ['抧']
抵: ['扯', '坁', '坻', '扺']
抶: ['垁', '挾']
抷: ['柸', '杜']
抸: ['扖', '牴', '抒']
抹: ['抺']
抺: ['抹', '捄', '妹', '棶']
抽: ['抐']
抿: ['姄', '捳']
拁: ['銣']
拂: ['绋']
拃: ['咋', '怍', '抄']
拄: ['忙', '牪']
拆: ['坼']
拇: ['坶']
拈: ['粘']
拉: ['拕', '忼', '扻', '袕']
拊: ['弣']
拋: ['抛']
拌: ['伴', '怑']
拍: ['粕']
拎: ['妗']
拏: ['拏', '挈']
拐: ['捛']
拒: ['抯', '徂']
拓: ['袥', '祏', '拓']
拔: ['披', '抜']
拕: ['拉', '袕']
拖: ['抱']
拙: ['捛']
拚: ['拱', '捖']
招: ['梠']
拝: ['捽']
拞: ['扯', '坵', '抬']
拡: ['扩', '抓']
拢: ['娏']
拣: ['撩', '搽']
拤: ['圤']
拦: ['炷', '徃']
拧: ['忓', '扞', '忏', '托', '扜', '圩', '柠']
择: ['绎']
拪: ['抦']
拫: ['搌', '裉']
括: ['抙', '拮', '拯']
拮: ['佶', '牿', '诘', '姞']
拯: ['抙', '括']
拱: ['扏', '垬']
拲: ['芓', '草']
拳: ['桊', '擧']
拴: ['抢', '拾', '括']
拷: ['栲', '挎']
拺: ['诔', '掶', '摤', '揀', '捈', '谏', '捒', '捺', '掠']
拼: ['捝', '执', '垪']
拾: ['扯', '垥', '抬', '坮', '抢', '峆', '始', '拴', '忴', '绐', '拾']
拿: ['章', '羣']
持: ['待']
挂: ['桂']
挃: ['牼', '桱']
挆: ['捰', '掇']
指: ['栺']
挈: ['拏', '拏']
按: ['桉']
挋: ['捏']
挌: ['狢', '褡', '掿']
挍: ['抰', '扠']
挎: ['拷', '陓', '揨', '俜', '徬']
挏: ['铜']
挒: ['挧']
挓: ['牸']
挔: ['捄', '浓', '妶']
挕: ['栮', '饵']
挗: ['擯']
挚: ['摮', '事', '寧', '牽', '絷', '摰']
挞: ['哒']
挟: ['埉', '陕']
挠: ['娆', '铙', '绕']
挢: ['抁']
挣: ['錚', '诤']
挤: ['哜']
挥: ['裈']
挧: ['捆', '挒', '掘']
挨: ['诶', '换', '揲']
挩: ['娔']
挪: ['擲']
挬: ['桲', '裨', '椑']
挭: ['捼']
挮: ['绨', '銻']
振: ['祳', '捰', '裖']
挰: ['捚']
挱: ['猀']
挲: ['掌']
挴: ['娒', '晦']
挶: ['捤']
挹: ['扡', '捂', '捃', '揑']
挻: ['搥']
挽: ['娩']
挾: ['垁', '楰', '浃', '抶']
捀: ['浲']
捁: ['抩']
捂: ['挹', '捃']
捃: ['捂', '铻']
捄: ['抺', '挔']
捅: ['埇']
捆: ['挧', '掆', '掘']
捈: ['婛', '拺', '掠']
捉: ['娖']
捊: ['娐']
捋: ['浖', '坪']
捌: ['捯']
捍: ['稈']
捎: ['揞', '娋']
捏: ['榣', '椐', '挋']
捐: ['埍']
捒: ['揀', '拺', '谏', '掠', '捺', '鍊']
捔: ['栦']
捕: ['埔']
捖: ['拚']
捙: ['撺']
捚: ['挰']
捛: ['拐', '鋁', '拙']
捜: ['揁']
捝: ['执', '拼']
损: ['屃', '揋', '掍']
捠: ['損']
捡: ['绘', '捻', '捦']
换: ['挨', '搩']
捤: ['挶']
捥: ['掖']
捦: ['捡']
捧: ['捲', '淎']
捩: ['棙']
捯: ['捌']
捰: ['挆', '锞', '探']
捱: ['揌']
捲: ['捧']
捳: ['抿']
捶: ['插', '掻']
捷: ['徢', '搏']
捸: ['掶', '捺']
捺: ['摖', '拺', '捒']
捻: ['捡', '棇', '捻']
捼: ['挭', '婑']
捽: ['拝', '祽']
捾: ['輨']
捿: ['淒', '撞']
掀: ['掫']
掃: ['婦', '擆', '撂', '摃', '搙', '搚']
掄: ['婨']
掅: ['猜', '襀', '皘', '嫧', '撌']
掆: ['捆', '裥', '襇']
掇: ['挆']
掉: ['绰', '婥', '慎']
掊: ['搭']
掌: ['挲', '棠']
掍: ['损', '裩', '摳']
掎: ['搳', '楨', '梼', '裿', '揁']
掐: ['塪']
排: ['绯']
掔: ['擊', '撆', '揅', '擘']
掕: ['稜', '搐', '摌']
掘: ['捆', '挧']
掜: ['抿', '棿']
掝: ['緎', '祴']
掟: ['徒']
掠: ['婛', '揀', '捈', '棕', '拺', '掠', '捒']
探: ['捰', '桗']
掤: ['搠', '搁', '堋']
推: ['谁']
措: ['猎', '棤', '错']
掫: ['撒', '掀']
掯: ['揹', '椅', '摕', '樻', '搚']
掰: ['搿']
掱: ['責']
掴: ['蝈', '棞']
掶: ['摤', '拺', '捸']
掷: ['揶']
掸: ['揷', '褝']
掺: ['摻']
掻: ['捶', '搔']
掼: ['搵', '揽']
掽: ['搃']
掾: ['褖']
揀: ['拺', '媡', '谏', '捒', '鍊', '掠']
揁: ['禎', '捜', '揎', '掎']
揂: ['猶']
揄: ['堬']
揅: ['掔']
揆: ['捵']
揇: ['腩', '摘']
揉: ['搮', '擽']
揌: ['捱']
揍: ['搝', '榛']
揎: ['搳', '搈', '值', '揢', '媗']
提: ['撰', '堤']
揑: ['挹']
插: ['捶']
揕: ['谌']
揖: ['揭']
揘: ['摠']
揙: ['谝']
揚: ['禓', '摥', '擐', '摀']
換: ['墺', '塻']
揜: ['墖']
揝: ['撦', '摕', '撸']
揞: ['捎']
揟: ['壻']
揠: ['攛', '褗']
揢: ['搳', '搈', '揎', '摔']
揣: ['媏', '擶']
揤: ['柳']
揥: ['褅']
揦: ['掤']
揨: ['婷', '挎', '槔', '惇', '楟']
揩: ['揺']
揪: ['锹', '撳']
揭: ['揖']
揮: ['擇', '撑', '撣']
揰: ['摟', '擢']
揲: ['挨', '堞']
揳: ['锲']
援: ['缓', '禐']
揶: ['掷', '擳', '鄮', '鎁']
揸: ['撦', '馇']
揹: ['椅', '掯', '搢', '摕']
揺: ['揩', '摇']
揻: ['楲']
揼: ['攃']
揽: ['掼']
揾: ['搵', '橻', '搤']
揿: ['撳']
搁: ['掤', '摑']
搃: ['掽']
搄: ['惬']
搆: ['媾', '撯', '攚', '構', '搘']
搈: ['搾', '搳', '揎', '揢']
搊: ['媰']
搋: ['禠', '擓']
搌: ['榐', '拫']
損: ['捠']
搎: ['槂']
搏: ['捷', '禣']
搐: ['擯']
搑: ['搭']
搒: ['嫎', '垮', '榜']
搓: ['褨']
搔: ['掻']
搕: ['攁', '嗑', '塩']
搗: ['槝', '擒', '搞']
搘: ['搆', '撯', '構']
搙: ['掃']
搚: ['埥', '擆', '摃', '撍', '掃', '摿']
搛: ['谦', '槏', '稴']
搜: ['挫', '嫂']
搝: ['揍']
搞: ['墙', '樯', '擒', '撱', '搗']
搠: ['掤']
搡: ['襙', '鎟']
搢: ['揹', '播', '撎', '摕', '懵']
搣: ['摵']
搤: ['镒', '鎰', '嗌', '搵', '揾', '橻', '塧']
搥: ['挻']
搨: ['褟', '禤', '塌']
搩: ['换']
搪: ['摠', '塘']
搫: ['篫']
搬: ['樧']
搭: ['搑', '掊']
搮: ['揉', '溧']
搱: ['稺']
搲: ['攐', '摭', '撩', '擦']
搳: ['搈', '揎', '掎', '揢']
搵: ['撮', '揾', '橻', '搤', '掼']
搶: ['撸', '滄', '撂', '熗', '獊']
搷: ['缜', '擯']
搼: ['擤', '攑']
搽: ['拣']
搿: ['掰']
摀: ['塢', '撝', '揚', '鎢']
摂: ['报']
摃: ['撜', '擂', '搚', '掃']
摇: ['猺', '揺']
摍: ['蹜']
摏: ['榬']
摑: ['搁']
摓: ['擿', '墶', '摙', '塳']
摔: ['淳', '揢']
摕: ['揹', '掯', '搢', '揝']
摖: ['撩', '擦', '捺']
摗: ['撳']
摘: ['擠', '嘀', '摛', '揇']
摙: ['璉', '摓', '撻']
摛: ['摘', '缡']
摜: ['攪']
摞: ['镙']
摟: ['鏤', '揰', '擐', '擢']
摠: ['揘', '擯', '梀', '搪']
摣: ['櫖', '擋', '擄', '櫨', '樝']
摤: ['擙', '掶', '拺']
摥: ['揚']
摧: ['鏙']
摩: ['塵']
摬: ['樈', '憶', '擕', '境', '襓']
摭: ['搲', '墌']
摮: ['孳', '撃', '摰', '挚']
摯: ['擧', '摰']
摰: ['摮', '撃', '摯', '挚']
摱: ['攖', '忁']
摳: ['掍']
摴: ['壖', '襦']
摵: ['搣']
摶: ['嫥', '撐', '橕']
摷: ['漅']
摸: ['擙', '镆', '撗']
摹: ['禀', '蔓']
摻: ['掛', '掺']
摽: ['樵']
摾: ['镪']
摿: ['撦', '撸', '擼', '嬒', '搚']
撀: ['縏', '擊', '撆']
撁: ['鏲']
撂: ['掃']
撃: ['摮', '摰']
撄: ['缨', '攖']
撆: ['掔', '撀']
撇: ['擻', '黴', '襒']
撈: ['鐒', '耮']
撉: ['擎']
撊: ['鐧', '埛', '嫻']
撋: ['爛']
撌: ['擋', '掅', '嫧']
撍: ['擆', '掊', '搚']
撎: ['澧', '擖', '搢', '嬄', '橞', '攅']
撏: ['撙']
撐: ['橕', '摶']
撑: ['撣', '擕', '擵']
撒: ['掫', '撖', '擏']
撓: ['褤']
撔: ['攥']
撖: ['撒', '榌', '擏']
撗: ['摸', '揽']
撘: ['塔']
撙: ['撏', '壿', '墫']
撚: ['撚']
撛: ['磷', '獜']
撜: ['摃', '镫']
撝: ['嬀', '擐', '摀']
撞: ['捿', '獞', '攉', '慒', '潼']
撟: ['橋']
撢: ['罈', '櫦', '禫', '櫔', '橝']
撣: ['擇', '撑', '揮']
撤: ['攡', '嫩']
撥: ['襏']
撦: ['擆', '揸', '摿']
撨: ['嫶']
撩: ['摖', '拣', '镣', '搲', '獠', '擦', '裗']
播: ['搢']
撮: ['搵']
撯: ['搆', '攉', '構', '慒', '搘']
撰: ['提']
撱: ['搞']
撳: ['揪', '摗', '揿']
撴: ['镦', '墽']
撵: ['擇']
撷: ['櫇', '襭']
撸: ['播', '揝', '捪', '擼', '搶', '樻', '擂']
撺: ['墇', '憭', '櫥', '捙', '憓']
撻: ['摙']
撽: ['檄']
撾: ['鐹']
撿: ['襝']
擂: ['澢', '摃']
擄: ['攎', '壚', '摅', '爐', '爐']
擆: ['撦', '搚', '撍', '掃']
擇: ['撵', '揮', '撣', '鏎']
擊: ['繫', '撆', '掔', '撀', '擘']
擋: ['摣', '撌', '樝']
操: ['鐰']
擎: ['撉']
擏: ['撒', '撖']
擐: ['镮', '欜', '鐶']
擑: ['橄']
擒: ['搞', '搗']
擓: ['攊', '擫', '搋']
擔: ['攆', '擡']
擕: ['撑', '摬', '塙']
擖: ['攅']
擗: ['礔', '鐴']
擘: ['嬖', '擊', '孹', '掔']
擙: ['摤', '瘈']
據: ['澽', '璩', '鐻', '攗']
擞: ['徼']
擟: ['欙', '攛']
擠: ['摘', '櫅']
擡: ['攉', '擔']
擢: ['摟', '揰', '擸', '躍', '褗']
擣: ['鑄', '幬', '攄', '懅']
擤: ['襣']
擥: ['舉']
擦: ['攐', '摖', '镲', '撩', '擽']
擧: ['摯', '拳']
擩: ['攉', '獳', '攂']
擭: ['嬳']
擯: ['搷', '搐', '摠', '挗']
擰: ['獰', '濘', '矃']
擱: ['壛', '攌']
擲: ['挪']
擳: ['揶']
擴: ['礦']
擵: ['撑']
擶: ['揣']
擷: ['攧']
擸: ['镴', '獵', '鑞', '攛']
擹: ['㨖']
擻: ['撇']
擼: ['撸', '樻', '摿']
擽: ['揉', '擦']
擿: ['摓']
攀: ['蠜']
攁: ['搕', '攮']
攃: ['揼']
攄: ['懅', '擣']
攅: ['撎', '擖', '檂', '擤', '攢']
攆: ['擔']
攈: ['攗']
攉: ['撯', '攂', '擩', '擢', '擡']
攊: ['擓']
攍: ['撅']
攎: ['獹', '攟', '墟', '壉']
攏: ['襱']
攐: ['搲', '擦']
攑: ['搼']
攖: ['攫', '撄']
攗: ['據', '攈']
攘: ['壤']
攚: ['懽', '瀯', '攫', '權']
攛: ['擟', '擸']
攝: ['囁']
攞: ['捰']
攟: ['攨', '攎']
攠: ['孊']
攡: ['撤']
攢: ['擤', '躦', '攅']
攣: ['孌', '筆', '欒']
攥: ['撔']
攧: ['擷']
攨: ['擫', '攟', '攇']
攩: ['灙']
攪: ['摜']
攫: ['攖', '攬']
攬: ['攫']
攭: ['欚']
攮: ['攁']
攱: ['晈']
攲: ['敧']
收: ['収']
攸: ['炇', '佽']
攽: ['敓']
敃: ['贁']
敆: ['欱']
效: ['敚']
敉: ['籹']
敋: ['贁']
救: ['教']
敓: ['攽']
敕: ['欶', '敘']
敘: ['敕']
教: ['救']
敚: ['效']
敛: ['散', '欴']
敞: ['敕']
敠: ['敪']
散: ['敛']
敧: ['攲']
敨: ['瓿']
敪: ['欼', '敠']
敯: ['敱']
敱: ['敯']
敳: ['數']
整: ['螫']
數: ['敳']
敹: ['僌']
敽: ['敿']
斀: ['敡']
斁: ['歝', '歜']
文: ['灾']
斈: ['荸', '蚉', '孪', '李']
斊: ['瓫', '聻']
斐: ['猆', '裴']
斒: ['徧', '糄']
斔: ['螤']
斕: ['孄']
斗: ['仯']
料: ['料']
斛: ['酙', '斜']
斜: ['斛', '鈄']
斤: ['亓', '元', '卩', '迁', '凣']
斦: ['所']
斨: ['肵']
斩: ['靳', '蚚', '斬']
斪: ['斯']
斫: ['歽']
斬: ['斩', '靳']
斮: ['新']
斯: ['斱', '斪']
新: ['斮', '齗']
斱: ['斯']
斶: ['觸', '臅']
斾: ['旆']
斿: ['侟']
旀: ['旎']
旅: ['旋', '旅']
旆: ['斾']
旇: ['旊', '旐', '旗']
旈: ['旒', '艈']
旉: ['書']
旊: ['旒', '旇', '旐', '旗']
旋: ['旅']
旎: ['旀', '旝']
旐: ['旊', '旇', '旗']
旒: ['旊', '旈']
旖: ['旝']
旗: ['旊', '旇', '旐']
旘: ['繊']
旜: ['麠']
旝: ['旖']
日: ['彐']
旧: ['冂', '臼']
早: ['录', '雽', '甼']
旪: ['吇', '吽']
旫: ['灱']
旯: ['昆']
旰: ['紝', '盱', '矸', '阡', '旴']
旱: ['狊']
旲: ['癸', '耎']
旳: ['旿', '昀']
旴: ['旰', '盱', '矸']
时: ['讨']
旹: ['峕']
旻: ['妥', '長']
旽: ['纯']
旿: ['吘', '旳', '吖', '昀']
昀: ['旳', '旿']
昁: ['眒']
昆: ['旯']
昉: ['眆']
昊: ['狊']
昌: ['是']
昐: ['吩']
昑: ['汵']
易: ['易']
昗: ['尝']
昙: ['票']
映: ['秧', '晚']
昣: ['眵', '陔']
昤: ['竛', '唥']
春: ['者', '舂']
昧: ['眯', '陎', '跊', '昩', '眛', '眜', '咣']
昩: ['吱', '昧', '味', '咪', '唻']
昫: ['咰', '眴', '眗', '呞']
昬: ['晉']
昰: ['呈', '晁']
昱: ['翌']
昲: ['咈', '绋']
昳: ['秩']
昽: ['咙', '眬']
显: ['虽']
昿: ['晈']
晀: ['唲', '晲']
晁: ['昰']
晅: ['桓']
晆: ['眭']
晇: ['咵']
晈: ['攱', '昿']
晉: ['昬']
晊: ['跮']
晍: ['哃']
晎: ['嗞', '硔']
晏: ['嬃', '吴']
晒: ['硒', '哂']
晘: ['哻', '垾']
晚: ['映']
晞: ['唏']
晢: ['皙', '哲', '晳']
晤: ['铻']
晥: ['暁', '啘']
晦: ['挴']
晪: ['睓']
晫: ['暭', '竨', '硨']
晬: ['埣', '晔']
普: ['替']
晰: ['唽', '哳']
晱: ['唢']
晲: ['婗', '唲', '晀', '睨']
晳: ['晢', '皙', '哲']
晴: ['睛', '嘈']
晵: ['啓', '暜']
晶: ['瞐']
晹: ['睗']
晼: ['睕']
晾: ['暕']
晿: ['唱']
暁: ['晥']
暄: ['埴', '矉']
暆: ['椸']
暈: ['暈']
暉: ['喗', '嚜', '嚯']
暊: ['頃']
暌: ['聧']
暎: ['唤']
暏: ['賭', '暗']
暒: ['睲']
暕: ['喍', '晾']
暗: ['暏']
暘: ['啺']
暙: ['睶', '媋']
暚: ['磘', '睉']
暜: ['晵']
暞: ['鎳']
暟: ['嗤']
暡: ['曦', '塕', '瞈', '嗡']
暣: ['嗅', '暸']
暤: ['嘷', '噑']
暦: ['曆', '曆', '脣']
暧: ['嗳']
暪: ['瞞']
暭: ['晫']
暮: ['蒷', '幕']
暯: ['瞙']
暲: ['皞', '嫜', '瞕', '傽']
暴: ['暴', '軣']
暸: ['曣', '暣']
暹: ['逿']
暺: ['嘽']
暽: ['噒', '驎', '瞵']
暾: ['礅']
暿: ['嬉', '曥', '礂', '瞦']
曀: ['噎']
曂: ['喷']
曃: ['嗹', '嚺']
曄: ['瞱']
曅: ['茟']
曆: ['磿', '暦', '曆']
曇: ['蕓', '羹', '雧']
曈: ['瞳']
曉: ['驍', '嘵']
曊: ['隤']
曋: ['瞫', '镡', '墰', '谭']
曍: ['嗱']
曐: ['量', '量']
曓: ['菓', '巢']
曕: ['瞻']
曖: ['瞹']
曘: ['嬬']
曚: ['曭']
曛: ['矄']
曜: ['曤', '曮', '矅', '嚁']
曠: ['啸']
曣: ['暸', '嚥']
曤: ['矐', '曜', '嚁']
曥: ['噹', '臚', '嘊', '矑']
曦: ['曨', '暡']
曨: ['曦', '嚨', '躘']
曪: ['囉']
曫: ['瞥']
曭: ['曚']
曮: ['曜', '矅']
曯: ['囑', '矚']
曰: ['尺', '口']
更: ['更']
曶: ['㫚']
書: ['旉', '雲']
曹: ['瞿']
曾: ['訾', '曽']
替: ['普']
朁: ['瞖']
朌: ['肦']
朏: ['胂', '脗']
朐: ['肑']
朑: ['脃', '脞']
朓: ['腓', '胇']
朕: ['胠', '肤', '股']
朖: ['桹']
朗: ['朗']
朘: ['賐', '朡']
朜: ['脝', '膟']
朡: ['陵', '陵', '朘']
朢: ['蕾']
朣: ['膧']
朧: ['贚', '蠬']
未: ['末']
末: ['卡', '未']
本: ['举']
札: ['朼']
朲: ['枟', '杠', '杁', '扑', '杧']
朳: ['朼', '杁']
朴: ['杉', '杠', '朾', '材', '村']
朷: ['初', '忉', '牞']
朹: ['拉', '抍', '扴', '忦', '柆']
机: ['柝', '杌']
朻: ['杓']
朼: ['札', '杁', '朳']
朽: ['柸']
朾: ['杉', '帄', '杠', '朴', '材', '村']
朿: ['宷', '宇', '柬', '亰', '束', '箂']
杁: ['朼', '朲', '枤', '朳']
杂: ['茱']
权: ['校']
杄: ['析', '籷', '衧', '粁', '扦', '杅', '杆', '杯', '杔']
杅: ['犴', '籷', '扦', '忓', '杯']
杆: ['籷', '衧', '粁', '杄', '杯', '杔']
杉: ['杠', '朴', '朾', '材', '村']
杋: ['枫', '枇']
杌: ['机', '枟', '打', '礽']
杍: ['枉', '抔', '扞', '籽', '杞', '托']
李: ['茡', '孛', '辛']
材: ['杉', '朴', '朾', '村']
村: ['杉', '朴', '朾', '材', '杖']
杒: ['糿']
杓: ['枦', '朻', '枃']
杔: ['籷', '粁', '杄', '杅', '杆', '杯']
杕: ['紎', '忕', '袄']
杖: ['柱', '杧', '村']
杗: ['苿']
杘: ['尿', '尿']
杙: ['桛']
杚: ['杜']
杛: ['梠']
杜: ['牡', '抷', '柸', '杚', '籵', '柾', '枆']
杝: ['杪', '栕', '栍', '枇', '袍']
杞: ['柘', '杍', '枉', '枮']
束: ['宷', '朿', '亰', '荥', '莵']
杠: ['杉', '朴', '忹', '彺', '柱', '朲', '呸', '狂', '忊']
杣: ['柮']
杤: ['柘']
来: ['丧', '來', '來']
杦: ['柼']
杧: ['杺', '牝', '柱', '朲', '抃', '牤', '杖']
杪: ['杝', '栍', '桢']
杫: ['杝']
杬: ['杭', '祈']
杭: ['杬', '圿', '祈']
杮: ['抪', '标', '桂', '杼']
杯: ['籷', '粁', '扦', '杄', '杅', '杆', '杔']
東: ['栆']
杲: ['寻']
杴: ['杵', '枚', '扻']
杵: ['柞', '杴', '杶', '柿', '狝', '桛']
杶: ['杵', '柿', '魨']
杷: ['枥', '粑', '柄']
杸: ['竐']
杹: ['柢', '枪']
杺: ['扑', '杧']
杻: ['枬', '杻']
杼: ['标', '枥', '柉', '杮']
杽: ['枰']
松: ['衳']
板: ['椗', '枞', '柀']
极: ['圾']
枂: ['相', '柌', '柺']
枃: ['杓', '柌']
构: ['枸', '袧', '杊']
枅: ['枌', '枡']
枆: ['柸', '粍', '杜', '栬']
枇: ['秕', '杝', '杋']
枈: ['染', '桬', '柒']
枉: ['杍', '抔', '籽', '杞', '托', '祍']
枋: ['牥']
枌: ['枅', '枡', '扮']
枍: ['栏']
枎: ['杪', '垁', '挾']
枏: ['衻']
析: ['杄']
枑: ['祖', '桓']
枒: ['枬', '柷']
枓: ['紏']
枔: ['枕', '扴', '柼']
枕: ['枔', '朹']
枖: ['秆', '枡', '忏', '托', '扜', '祍']
林: ['林']
枘: ['袖']
枙: ['柄']
枚: ['找', '杴', '权', '妆']
枛: ['榣', '枾']
果: ['甼']
枝: ['怶', '梏', '梜']
枞: ['袱', '板', '挀']
枟: ['忹', '朲', '祀', '杌', '紜']
枠: ['柞']
枡: ['枅', '枌', '圿', '枖']
枢: ['柩', '枧']
枣: ['栆', '叀', '肀']
枤: ['杁']
枥: ['呖', '杷']
枦: ['怕']
枧: ['枢']
枨: ['桄']
枪: ['枱', '栓', '杹', '柉']
枫: ['栀', '柧', '楃']
枬: ['枒', '柷', '杻']
枮: ['杞']
枯: ['拈']
枰: ['杽', '柯']
枱: ['栓', '柑', '枪', '帕']
枲: ['车', '皁']
枳: ['柷', '柤', '岄']
枴: ['杨']
枵: ['梔', '梧', '椐']
枷: ['铷']
枸: ['袧', '构', '杊']
枺: ['核', '棯', '梽', '梂', '梾']
枼: ['菜']
枽: ['苹', '荚', '桒', '萗', '菜']
枾: ['纯']
枿: ['柿']
柀: ['鈹', '板']
柁: ['柠']
柂: ['柎', '袘']
柃: ['栓', '枪']
柄: ['枙', '杷']
柅: ['枙', '坭']
柆: ['拉', '朹', '抆']
柈: ['坢']
柉: ['牦', '标', '桂', '抚', '杼', '枪']
柊: ['终']
柋: ['牮']
柌: ['裐', '椆']
柍: ['抰', '枰', '校', '杴']
柎: ['柂', '栰', '祔']
某: ['蒅', '秶']
柑: ['枱', '梤', '桰', '棁', '楯']
柒: ['梁', '染', '梁', '栥', '榘', '桬', '枈']
染: ['梁', '栥', '梁', '桬', '樂', '樂', '柒', '樂']
柔: ['檕']
柗: ['坫']
柘: ['杞', '杤']
柚: ['柮']
柜: ['柯', '秬', '柤']
柝: ['机']
柞: ['杵', '祚', '枠']
柟: ['姌', '呥', '梏']
柠: ['柁', '忏', '扜', '圩', '拧']
柡: ['梀', '棌', '榇']
柢: ['杹']
柣: ['桢']
柤: ['岄', '岨', '柯', '柜', '秬', '杻', '枳', '岠', '杻']
柦: ['桓']
柧: ['枫', '栀']
柨: ['栫', '梜', '栨']
柫: ['炥', '楢']
柬: ['朿']
柭: ['紱', '検', '根']
柮: ['杣', '柚']
柯: ['枰', '柜', '柤']
柰: ['寀', '穻']
柱: ['杠', '抃', '牤', '杖', '杧']
柳: ['柳']
柵: ['樮', '栭']
柶: ['橺']
柷: ['祝', '枳']
柸: ['抷', '妚', '仠', '朽', '扗', '柾', '枆', '杜']
柹: ['梜', '祛', '桙']
柺: ['捐', '枂']
柼: ['枔', '坑', '抗', '彷', '杦', '扴', '牨']
柽: ['樦']
柾: ['柸', '桮', '杜']
柿: ['杵', '枿', '杶']
栀: ['枫', '柧']
栁: ['榊']
栂: ['棏', '櫸']
栆: ['東', '嵾', '枣']
标: ['栓', '杼', '柉', '杮']
栊: ['垅']
栋: ['捈', '栎', '株']
栍: ['杪', '杝', '槯']
栎: ['栋', '様']
栏: ['枍', '椌', '栟']
树: ['桝']
栓: ['枱', '标', '銓', '柃', '枪']
栔: ['槧']
栖: ['梄']
栗: ['粟', '栗']
栙: ['掉', '袶', '樬']
栚: ['栻', '栟']
栛: ['楄']
栜: ['楾', '徚', '梳', '棣', '棶', '倲']
栝: ['扗', '桮']
栟: ['栻', '拱', '栚', '栏']
校: ['柍', '抰', '权', '坆']
栢: ['祒', '袹']
栣: ['秹', '袵']
栤: ['鉥']
栥: ['梁', '染', '粢', '梁', '桬', '荼', '柒']
栦: ['捔', '梸']
栧: ['桂']
栨: ['柨', '梜']
栩: ['棢']
株: ['姝', '栋']
栫: ['柨']
栬: ['祪']
栭: ['緬', '柵', '媔']
栮: ['饵', '挕']
栯: ['楮']
栱: ['畊', '哄']
栲: ['桍', '拷', '挎']
栵: ['棚', '榊']
核: ['梽', '姟', '棂']
根: ['棵', '柭']
栺: ['指', '椬']
栻: ['扏', '栟']
格: ['楉']
栾: ['楽']
桁: ['栫']
桂: ['栳', '栧', '挂', '柉', '杮']
桃: ['椪']
桄: ['枨']
桅: ['陒']
框: ['櫃', '棍', '梶', '榧']
案: ['寨']
桉: ['按']
桊: ['拳']
桋: ['櫁', '檳', '槙']
桍: ['栲', '椁', '犉', '楟', '榜']
桎: ['秷', '榣', '樱', '銍']
桐: ['榒']
桑: ['巣']
桒: ['枽', '菜']
桓: ['柦', '枑', '晅']
桔: ['袺']
桖: ['裇', '榓']
桗: ['探', '裸']
桙: ['桳', '棦']
桛: ['杵', '杙']
桝: ['棥', '树', '抩', '桫']
桞: ['梆', '梛', '郴']
桠: ['樒', '椬']
桢: ['杪', '柣', '栈']
档: ['槄']
桤: ['棔']
桥: ['扴']
桧: ['給', '裣', '检', '梳']
桨: ['穾', '奖', '寀', '棨']
桩: ['扯']
桪: ['枰', '挦']
桫: ['桝']
桬: ['梁', '染', '梁', '栥', '椝', '柒', '槃']
桭: ['娠']
桮: ['栝', '柾']
桯: ['梫', '裎']
桰: ['捂', '楯', '楿']
桱: ['挃', '徑']
桲: ['挬', '裨', '椑', '梈']
桳: ['桙']
桶: ['棢']
桸: ['稀']
桹: ['朖', '棙']
桺: ['埡']
桻: ['槣', '峰', '橭']
桽: ['鐢', '髽']
桾: ['据', '桰', '梧']
梀: ['椋', '榇', '梾', '棟', '悷', '摠', '楝', '柡']
梁: ['染', '梊', '粱', '梁', '栥', '榘', '桬', '柒', '槃']
梂: ['梽', '枺', '梾']
梃: ['蜓']
梄: ['榴', '栖', '橊']
梅: ['烸', '榵', '橰']
梆: ['桞', '郴']
梇: ['楞', '桰', '梧']
梈: ['﨔', '桲']
梊: ['梁', '梁', '椝']
梋: ['裐']
梌: ['棶']
梏: ['枝']
梑: ['樕']
梒: ['抬', '棔']
梓: ['椊']
梔: ['椐']
梕: ['梞']
梖: ['椇']
梗: ['楼']
梙: ['橰', '槔']
梛: ['桞', '榔']
梜: ['柹', '柨', '蛺', '枝', '坱', '栨']
梞: ['梕']
梠: ['杛', '招']
梢: ['绡', '娋', '榜', '陗']
梥: ['集', '紊']
梧: ['楆', '榣', '棓', '桾']
梨: ['梨', '楘']
梪: ['絙', '榎', '棍']
梫: ['侵', '桯', '椶']
梬: ['絝', '搏']
梭: ['棪', '稜']
梮: ['椐']
梯: ['挮', '娣']
械: ['诫', '祴']
梱: ['裍', '稇', '稛', '祵']
梲: ['挩']
梳: ['榇', '樜', '栜']
梶: ['框', '棍', '楩', '楯']
梸: ['栦']
梹: ['娦']
梺: ['楚']
梼: ['铸', '德', '掎', '祷']
梽: ['核', '梂', '枺', '娡']
梾: ['椋', '梀', '梂', '榢', '榇', '棟', '楝']
梿: ['鲢']
检: ['桧']
棁: ['帨', '梶', '柑', '哾', '娧', '拚', '祱']
棂: ['核', '犋', '椇']
棃: ['槷', '棸', '秶']
棄: ['茣', '菒', '泰', '菓', '奠']
棅: ['楪', '樑', '橖', '棶']
棆: ['埨', '惀']
棇: ['捻', '捻']
棈: ['樍', '槫']
棉: ['褅', '绵']
棋: ['蜞']
棌: ['棎', '椂', '綵', '柡']
棍: ['梪', '框', '梶', '楩', '椳']
棎: ['棌', '椂']
棏: ['淂', '栂']
棐: ['奜']
棑: ['裶']
棒: ['捧', '槴']
棓: ['榣', '榕', '榙', '梧', '稖']
棔: ['橮', '桤']
棕: ['椗', '婃', '掠']
棖: ['樏']
棗: ['罺']
棙: ['捩', '桹']
棚: ['栵', '楖']
棛: ['檣']
棝: ['棢']
棞: ['棡', '槶', '椢', '祻', '棢', '掴']
棟: ['横', '椋', '梀', '煉', '榇', '梾', '煉', '楝']
棠: ['喿', '掌']
棡: ['槶', '棢', '棞', '犅', '椆']
棢: ['棡', '棞', '棝', '椆']
棣: ['栜']
棤: ['措']
棥: ['桝']
棦: ['桙']
棨: ['桨', '寀']
棩: ['裫']
棪: ['榽']
棬: ['椦', '裷']
棭: ['椀', '榬', '槉']
棯: ['枺']
棰: ['娷', '睡']
棱: ['抟']
棲: ['橦', '悽']
棵: ['楾', '綶']
棶: ['抺', '捄', '裌', '栜', '棅', '梌', '婡']
棸: ['棃', '秶']
棹: ['婥', '掉', '幀', '愺']
棻: ['葦', '薬', '槖', '薒', '葇']
棿: ['掜', '椀', '楰']
椀: ['棭', '榢']
椁: ['桍', '犉', '楟', '蜳']
椂: ['棎', '棌', '樏']
椃: ['榩']
椅: ['揹', '掯', '楂']
椆: ['棡', '楣', '徟', '棢', '柌', '櫋', '楇']
椇: ['梖', '榠']
椊: ['梓']
椋: ['梀', '榢', '榇', '橑', '梾', '棟', '椓', '倞']
椌: ['栏']
植: ['櫁', '槒', '檳', '禃', '楦', '槙']
椐: ['梔', '枵', '榣', '婮', '梮', '樨', '捏']
椑: ['焷', '桲', '俾', '挬', '裨']
椒: ['婌']
椓: ['椋', '梾']
椗: ['棕', '绽', '板']
椙: ['榋', '裮', '楬']
検: ['柭']
椝: ['梊', '榘', '桬', '槃']
椞: ['娎', '寀', '椠']
椟: ['樉', '摬', '櫥', '榬', '椲']
椠: ['椞']
椢: ['槶', '棞']
椥: ['柳']
椦: ['棬']
椧: ['樀', '樐']
椪: ['桃']
椬: ['桠', '栺', '榁']
椮: ['滲', '襂', '穇']
椯: ['樆', '煓', '褍']
椰: ['檌']
椱: ['愎', '槙']
椲: ['樈', '摬', '椟', '榱', '煒', '褘', '禕']
椳: ['棍', '楩']
椶: ['楼', '梫']
椷: ['堿']
椸: ['暆', '嫙']
椻: ['榧']
椽: ['橡']
椿: ['摏', '帱', '鰆', '樁']
楁: ['愘', '楷', '榷']
楂: ['櫓', '椅', '櫓', '櫅', '樻']
楃: ['枫', '媉']
楄: ['栛', '牑']
楆: ['櫻', '樱', '梧', '橙']
楇: ['楣', '椆']
楈: ['幘']
楉: ['格', '楛']
楌: ['偐']
楎: ['槹', '愩']
楏: ['榫']
楓: ['姵', '櫰']
楕: ['槁', '褠', '構', '櫅', '槝']
楖: ['棚']
楗: ['槤']
楘: ['琹', '梨', '梨', '菜']
楚: ['葅', '梺']
楛: ['橫', '楉']
楜: ['媩']
楝: ['椋', '梀', '榇', '梾', '棟']
楞: ['檈', '愣']
楟: ['椁', '婷', '桍', '揨', '嵉', '慞']
楠: ['樆', '揇']
楢: ['煪', '柫']
楣: ['楇', '椆']
楦: ['楻', '檳', '徝', '樒', '榁', '樬']
楧: ['榤']
楨: ['槞', '褃', '掎', '樐', '檟', '揁']
楩: ['棍', '梶', '椳']
楪: ['蟝', '樑', '棅', '橖']
楬: ['榋']
楮: ['媎', '揞', '褚']
楯: ['桰', '梶']
楰: ['枫', '掜', '榢']
楱: ['褤', '榡']
楲: ['揻']
楳: ['媒']
楶: ['薬', '巢', '葇']
楷: ['楁']
楺: ['櫒', '橡', '媃']
楻: ['櫁', '槒', '楦']
楼: ['梗', '椶']
楽: ['粂', '栾', '秶']
楾: ['棵', '栜']
楿: ['桰', '楯']
榀: ['橸']
榁: ['樒', '椬']
概: ['溉']
榃: ['营']
榅: ['缊']
榆: ['媮', '鍮']
榇: ['椋', '梀', '橑', '梾', '棟', '楝', '柡']
榈: ['恫']
榊: ['栵']
榋: ['椙', '楬']
榌: ['撖']
榍: ['榒']
榎: ['梪', '樌', '櫂']
榏: ['掽', '檢']
榐: ['榌', '搌']
榑: ['縛']
榒: ['桐', '榍']
榔: ['梛']
榕: ['棓', '樒', '榙', '樬']
榖: ['嗀', '嗀']
榗: ['穯', '縉']
榘: ['梁', '梁', '椝', '柒']
榙: ['榕', '棓']
榛: ['揍', '樔', '櫎']
榜: ['桍', '嫎', '搒', '梢', '垮']
榝: ['樧']
榟: ['伡']
榠: ['椇']
榡: ['槁', '褄', '槕', '楱', '槝', '櫎', '槺']
榢: ['惊', '椀', '梾', '楰', '檧']
榣: ['棓', '樱', '梧', '椐', '捏']
榤: ['楧', '樑']
榧: ['框', '椻', '櫃', '樞', '挳']
榨: ['槹']
榩: ['櫺', '摢', '椃']
榪: ['禡', '槵', '欍']
榫: ['﨔', '楏']
榬: ['樈', '摏', '棭', '椟', '榱']
榭: ['埘']
榮: ['嫈']
榰: ['樍', '慒', '褿', '橨', '櫣']
榱: ['樉', '櫥', '榬']
榴: ['橊']
榵: ['槆']
榶: ['櫗']
榷: ['楁']
榹: ['嗁']
榺: ['滕']
榻: ['槅']
榽: ['棪']
榿: ['隑']
槀: ['禀', '裛', '稁']
槁: ['榡', '楕', '槝', '搗', '槺']
槂: ['搎']
槃: ['梁', '梁', '桬', '樂', '樂', '椝', '樂']
槄: ['档']
槅: ['榻']
槆: ['橁', '榵']
槈: ['樌']
槉: ['棭', '橴']
槊: ['檕']
構: ['媾', '搆', '撯', '搘', '煹']
槍: ['橞', '榶']
槏: ['搛', '谦', '嫌', '溓']
槑: ['罧']
槒: ['櫁', '楻', '檳', '徝', '植', '傗']
槓: ['榎', '椳', '隫']
槔: ['梙', '揨', '橰']
槕: ['榡', '嵲', '樜', '槺']
槖: ['奦', '橐', '菄', '棻', '薒']
槗: ['慯', '褵']
様: ['檬', '檨']
槙: ['檳', '桋', '嵮', '植', '椱']
槛: ['檻']
槜: ['槣', '愯']
槝: ['槁', '榡', '楕', '搗']
槞: ['楨']
槟: ['嫔']
槠: ['樐']
槡: ['櫒']
槣: ['槜', '樟']
槤: ['槰', '橽', '楗', '樽', '槴', '禟']
槥: ['樘']
槦: ['檣', '墉', '欓', '慵']
槧: ['栔']
槨: ['漷', '郴']
槩: ['喿', '檗']
槫: ['棈', '檮']
槭: ['檝', '缄', '緘']
槯: ['栍']
槰: ['橽', '槴', '槤', '檵']
槱: ['櫺', '禫']
槲: ['櫯']
槳: ['獎']
槴: ['槰', '槵', '槤', '檐', '櫥']
槵: ['槴', '榪']
槶: ['棡', '椢', '棞']
槷: ['棃', '漐']
槹: ['榨', '楎']
槺: ['糠', '楾', '槕', '檢', '榡', '櫎']
槼: ['嫢', '粊']
槽: ['糟']
樀: ['樐', '檶', '椧']
樁: ['埲', '摏', '椿', '橈']
樂: ['樂', '樂', '樂', '祟']
樃: ['櫊']
樆: ['椯', '楠']
樇: ['檇']
樈: ['欆', '憶', '摬', '榬', '椲']
樉: ['椟', '榱']
樋: ['楯']
樌: ['櫍', '穞', '槈', '櫂']
樍: ['耫', '樗', '榰', '檮', '橲', '橨', '擣']
樏: ['棖', '樑', '椂']
樐: ['樀', '樚', '楨', '椧', '槠']
樑: ['楪', '榤', '樏']
樒: ['桠', '榁', '樬', '楦']
樓: ['槇', '櫮', '樓']
樕: ['嫩']
樗: ['樍', '橲', '橨']
樘: ['槥']
標: ['熛']
樚: ['櫥']
樛: ['樱']
樜: ['槕', '梳']
樝: ['櫖', '摣', '擋', '檽', '擄', '櫨', '橚']
樞: ['櫃', '慪', '愝', '榧', '偃']
樟: ['幥', '槣', '嶂', '嫜']
樠: ['橫']
模: ['橂']
樢: ['鳰', '鵭', '嶋', '鵴', '鴗', '鳩']
樣: ['檥']
樦: ['柽']
樧: ['榝', '搬']
樨: ['椐']
横: ['穔', '棟']
樫: ['俚']
樬: ['樒', '憁', '楦', '熜']
樭: ['橫']
樮: ['憟', '柵']
樯: ['墙', '橦', '橣', '搞', '嫱']
樰: ['檟', '櫺', '檔', '橎']
樱: ['楆', '桎', '櫻', '樛', '榣', '橙']
樴: ['櫼']
樵: ['摽']
樻: ['嬇', '櫓', '掯', '櫓', '檂', '撸', '擼', '楂', '橞', '檑', '皟', '幘']
樽: ['嶟', '槤', '梼']
橁: ['槆']
橂: ['模', '糢', '橈']
橄: ['櫢', '擑', '豃']
橆: ['蕀']
橈: ['橂', '樁']
橉: ['燐', '燐', '僯']
橊: ['榴', '梄']
橋: ['撟', '橕']
橌: ['欄']
橍: ['櫩', '棡']
橎: ['襎', '嬏', '燔', '檑', '嶓', '樰', '檔']
橐: ['蘃', '蘽', '藥', '槖', '嚢']
橑: ['椋', '榇']
橕: ['橋', '撐', '摶']
橖: ['楪']
橗: ['痈']
橘: ['壖', '檂']
橙: ['燈', '樱', '僜']
橚: ['櫖', '檽', '擄', '櫨', '樝']
橛: ['撅', '獗']
橜: ['簗']
橝: ['鱏', '罈', '禫', '撢']
橞: ['櫓', '撎', '櫓', '檂', '樻', '槍']
機: ['穖']
橡: ['椽', '楺']
橢: ['橳']
橤: ['粲']
橥: ['槃']
橦: ['樯', '檍', '橫', '棲', '櫅', '橣', '櫿', '愭']
橧: ['矰', '竲']
橨: ['櫝', '樍', '耫', '榰']
橫: ['樭', '樠', '儣']
橬: ['欍', '櫕']
橭: ['桻']
橮: ['欅']
橯: ['軂', '撈', '楞', '檼', '欑', '櫕', '蟧']
橰: ['梙', '槔']
橲: ['樍', '樗', '繥']
橴: ['槉']
橵: ['橶']
橶: ['橵']
橸: ['榀', '櫑']
橺: ['檲', '櫩', '柶']
橻: ['搵', '揾', '搤']
橼: ['櫞']
橽: ['槰', '槴', '槤']
橾: ['嬠', '缲', '臊']
橿: ['欍', '檯', '櫮']
檀: ['襢']
檁: ['欜', '欙']
檂: ['櫓', '橘', '櫓', '橞', '攅', '樻', '膿']
檄: ['撽']
檇: ['槣', '樇', '櫷', '懏']
檈: ['儇', '僓']
檌: ['椰']
檍: ['橦', '臆', '櫿']
檐: ['櫺', '槴', '檵']
檑: ['襎', '搢', '襠', '樻', '擂', '檔', '橎']
檔: ['檑', '襠', '檤', '橎']
檕: ['槊', '漀', '檠', '柔', '檗']
檗: ['槩', '檠', '檕']
檚: ['徥']
檛: ['嫗']
檝: ['槭']
檟: ['檯', '櫺', '懂', '楨', '樰']
檠: ['檕', '檗']
檡: ['襗']
檢: ['榏']
檣: ['棛', '槦', '墉']
檥: ['嬟', '樣']
檦: ['欄']
檧: ['榢']
檨: ['檬', '様']
檬: ['様', '檨']
檮: ['樍', '鑄', '續', '幬', '擣', '槫']
檯: ['欍', '櫮', '檟', '橿']
檲: ['橺']
檳: ['櫁', '槒', '桋', '禃', '植', '穦', '欑', '櫕', '槙']
檵: ['槰', '檐']
檷: ['櫮']
檸: ['繂']
檻: ['槛']
檼: ['櫕', '橯']
檽: ['櫝', '櫖', '糥', '燸', '橚', '樝']
檿: ['縻']
櫁: ['楻', '槒', '檳', '慉', '植']
櫂: ['榎', '櫃', '櫍', '欋', '樌']
櫃: ['框', '愝', '榧', '樞', '櫂']
櫄: ['禱']
櫅: ['橦', '擠', '楂', '楕', '蠐', '愭']
櫇: ['撷', '槻']
櫊: ['樃']
櫋: ['椆']
櫍: ['槚', '樌', '懫', '櫂', '慣']
櫎: ['榡', '懭', '欉', '槺']
櫐: ['櫫', '纍']
櫑: ['橸']
櫒: ['槡']
櫓: ['櫓', '禧', '檂', '撸', '擼', '楂', '橞', '襜', '樻', '糩']
櫔: ['嶠', '爄', '撢']
櫕: ['檳', '橬', '檼', '儹', '欑', '橯']
櫖: ['摣', '擄', '櫨', '樝']
櫚: ['櫩']
櫜: ['橐', '藳']
櫝: ['檽', '獖', '幩', '橨']
櫞: ['橼']
櫢: ['橄']
櫣: ['榰']
櫥: ['撺', '樚', '槴', '榱', '懡']
櫨: ['櫖', '摣', '橚', '樝']
櫩: ['櫚', '橺', '橍', '憪', '椡']
櫪: ['欜']
櫫: ['虊', '櫐']
櫮: ['欍', '檯', '樓', '慍', '檷', '橿']
櫯: ['槲']
櫳: ['巄', '隴']
櫴: ['濑']
櫵: ['壎']
櫸: ['欅']
櫺: ['槱', '榩', '欗', '檐', '禰', '樰', '檵']
櫻: ['楆', '樱', '欔']
櫼: ['孅', '樴']
櫿: ['橦', '檍', '傮', '愭']
欀: ['躟', '瀼', '孃']
欄: ['欄', '檦']
欅: ['櫸', '橮']
欆: ['樈', '椟']
欇: ['灄']
欉: ['櫎']
權: ['懽', '攚', '蠸']
欋: ['欔', '櫂']
欍: ['檯', '櫮', '橿', '榪']
欎: ['欝']
欏: ['欕']
欑: ['櫁', '檳', '檼', '穦', '櫕', '橯']
欒: ['孌', '奱', '攣']
欓: ['檬', '矘']
欔: ['櫻', '欋']
欕: ['欏', '礹']
欗: ['爤']
欙: ['擟', '檁']
欚: ['攭']
欜: ['擐', '櫪', '儾']
欝: ['欎']
欞: ['墵']
欠: ['攵']
欢: ['肷']
欣: ['肷']
欥: ['旼']
欨: ['欯']
欭: ['歠']
欯: ['欨']
欱: ['敆']
欲: ['谹']
欳: ['龡', '歒']
欴: ['敛', '鈌']
欵: ['歎']
欶: ['敕', '歒']
欸: ['歈']
欼: ['敪', '歌', '歜']
欽: ['鈼', '鈆', '飲', '鈜', '飮']
款: ['歀']
欿: ['歍']
歀: ['款']
歄: ['歙', '歍']
歆: ['赥']
歈: ['欸']
歉: ['歠']
歋: ['歠']
歌: ['欼', '歝', '歜']
歍: ['歙', '歄', '欿']
歎: ['欵']
歏: ['歕']
歐: ['歞']
歒: ['龡', '欶', '欳']
歕: ['歏', '歘']
歗: ['獻', '歙']
歘: ['歕']
歙: ['歗', '歄', '歍']
歜: ['欼', '歌', '歝']
歝: ['歌', '斁', '歜']
歞: ['歐']
歠: ['歉', '歡', '欭', '歋']
歡: ['歠', '觀']
歨: ['走']
歩: ['歺', '半']
歪: ['佱']
歫: ['爼']
歯: ['齒']
歴: ['歷', '歷']
歵: ['瞔', '磧', '積']
歷: ['蜃', '歷', '歴']
歺: ['歩']
歼: ['汙', '肝', '汗', '幵']
歽: ['斫']
殂: ['组', '鉏']
殆: ['炲', '佮']
殊: ['袾']
殎: ['趺', '趹', '殏', '跤']
殏: ['殎']
殓: ['跲', '硷']
殕: ['稖']
殖: ['碹', '殯']
殗: ['硽']
殜: ['碟']
殝: ['殥']
殡: ['殥']
殥: ['殝', '殡']
殦: ['鳷', '鵙', '鵖', '鵐', '鴊', '鴎', '鴖']
殭: ['氇', '殨', '氌']
殮: ['殮']
殯: ['殖']
殱: ['襳']
殴: ['骰']
殹: ['毆']
毀: ['毁']
毁: ['毀']
毂: ['瞉', '豰']
毆: ['殹']
毉: ['轚']
毒: ['壹', '寚']
毕: ['窂']
毗: ['吪']
毛: ['艳', '宅']
毝: ['毡']
毞: ['毣']
毣: ['毞']
毦: ['恥']
毲: ['氄']
毵: ['毿']
毽: ['遈']
毿: ['毵']
氀: ['氃']
氂: ['騖']
氃: ['氋', '氄', '氀']
氄: ['氃', '毲']
氆: ['毸']
氇: ['氌']
氋: ['氃']
氌: ['氇', '殭']
氐: ['疣']
氒: ['秊', '秊', '牟']
氓: ['眠']
气: ['氘']
氕: ['宍']
氘: ['气']
氙: ['氤', '氛']
氚: ['炰']
氛: ['氙', '氤']
氝: ['氠']
氠: ['氝']
氡: ['氩']
氤: ['氙', '氛']
氥: ['氫', '氱']
氩: ['氡', '氬']
氫: ['氥', '氱']
氬: ['氩']
氱: ['氥', '氫', '電']
氵: ['丯']
永: ['尗']
氺: ['卞', '亻', '平']
氾: ['汜', '況', '沑', '沉']
氿: ['汍', '汃', '汒']
汀: ['亓', '玎', '饤', '汅']
汁: ['灶', '汙', '汏', '汑', '讣']
汃: ['汣', '汍', '笊', '氿', '汒']
汄: ['丷', '仏', '沋']
汅: ['彐', '沰', '丅']
汇: ['氾', '辶', '泾', '辽', '汜', '江', '迉', '沑']
汈: ['元', '幻', '汋']
汉: ['汣', '汪', '沍']
汊: ['沃']
汋: ['沪', '灲', '勺', '沕', '汈', '伨']
汌: ['训', '饳', '刓']
汍: ['汣', '汃', '汶', '氿']
汎: ['沜', '仉']
汏: ['汁', '忲', '沃']
汐: ['汣']
汑: ['汁', '汗']
汒: ['伫', '汃', '工', '氿']
汓: ['只', '江']
汔: ['沘', '忔', '泡', '犵']
汕: ['油', '诎']
汗: ['汙', '汘', '歼', '汑', '环']
汘: ['汙', '卄', '歼', '汗', '佇']
汙: ['汘', '歼', '汗', '环']
汚: ['沔', '污', '汵', '洦', '活']
汛: ['迅', '尺', '讯', '沑']
汜: ['氾', '汨', '況', '汇', '沑', '沉']
汞: ['丟']
江: ['冗', '辶', '辽', '汓', '沍', '汇', '匸']
池: ['泩']
污: ['泙', '沔', '洰', '汚', '汵']
汢: ['还', '迂', '辻', '沈', '注', '沧', '沈', '诠']
汣: ['汉', '汐', '汍', '汃', '丿', '汶']
汥: ['濱', '洝', '泫']
汦: ['沘', '洸']
汧: ['洱']
汨: ['泅', '汜', '汩', '沺', '沼']
汩: ['泅', '汨', '沺']
汪: ['汉', '泟', '亅', '汻', '沍']
汫: ['沋', '讲']
汬: ['荄', '萊']
汭: ['泀']
汲: ['伋']
汴: ['并', '仲']
汵: ['泙', '汚', '污', '昑', '沽']
汶: ['汣', '汍', '沈', '注', '沈']
汷: ['泬', '汶']
決: ['泱']
汻: ['汪', '汼']
汼: ['泙', '沈', '注', '汻', '井', '沈']
汿: ['泾']
沁: ['沰']
沂: ['浐']
沅: ['巟', '沋', '汄']
沆: ['泬']
沇: ['沘', '涚']
沈: ['汶', '沈', '汼']
沉: ['沢', '氾', '汜']
沋: ['汫', '沅', '犹', '汄']
沍: ['汉', '泟', '汪']
沏: ['泀']
沐: ['沭', '沵']
沑: ['迅', '氾', '汛', '汜', '讯', '汇']
沒: ['没']
沔: ['泙', '汚', '河', '洦', '活']
沕: ['汋']
沗: ['乘']
沘: ['沇', '泝']
沚: ['泛', '处', '沽']
沛: ['犻', '洋', '沣', '泎', '沶']
沜: ['汎']
沟: ['泃']
沠: ['沌']
没: ['沒']
沢: ['況', '沉']
沣: ['炐', '阼', '沛', '侺', '仹']
沤: ['讴']
沧: ['汃', '泹', '汢']
沪: ['汋', '泊']
沫: ['流', '沬', '流', '浗', '浨']
沬: ['流', '泳', '沫', '浨']
沮: ['伹', '怚', '洰', '洹']
沰: ['泟', '丅', '沁']
沱: ['泬', '泊']
河: ['沔', '洰', '洦']
沵: ['沐']
沶: ['沛', '伃']
沸: ['浠']
油: ['汕']
沺: ['泅', '汨', '泏', '汩', '沼']
治: ['诒', '浴']
沼: ['泅', '汨', '沺']
沽: ['沾', '达', '沚', '沈', '沈']
沾: ['沽']
沿: ['泾']
泀: ['汭', '沏']
況: ['氾', '汜', '炾']
泂: ['浻', '涸', '悯', '侗', '涧']
泃: ['沟']
泄: ['涖']
泅: ['汨', '泏', '汩', '沺', '沼']
泆: ['佉']
泈: ['洛', '洛']
泉: ['隶']
泊: ['沪', '洎', '沱']
泋: ['侍', '洔']
泎: ['汷', '沛']
泏: ['泅', '沺']
泐: ['测', '測']
泑: ['浏']
泗: ['洄']
泘: ['烀', '浖', '件']
泙: ['沔', '污', '汵', '汼']
泚: ['洮']
泛: ['沚', '徔', '迁']
泝: ['诉']
泞: ['炐', '泎', '沱']
泟: ['沰', '汪', '亅', '沍']
泡: ['汔']
泣: ['过', '沍']
泥: ['伲', '洉', '泥']
注: ['汶', '汼']
泩: ['池', '狌']
泫: ['浹', '伭', '汥']
泬: ['汷', '汣', '沆', '沱']
泰: ['棄']
泱: ['悏', '決']
泳: ['沬', '洣']
泴: ['盕', '盇']
泸: ['芦']
泹: ['怛', '但']
泾: ['沿', '辽', '汿']
泿: ['辰']
洁: ['诘']
洄: ['滔', '泗']
洅: ['侢', '浥', '涺']
洆: ['涇']
洇: ['個']
洉: ['泥', '泥', '洱']
洋: ['烊', '沛']
洌: ['浰']
洎: ['诌']
洏: ['湎']
洒: ['恓']
洓: ['漺', '湅', '洡']
洔: ['泋', '侍', '浔']
洕: ['佾']
洖: ['澋', '渓', '湲', '娱']
洘: ['渮']
洚: ['淖', '袶']
洛: ['洛', '渃', '佫', '泈', '悋']
洝: ['濱', '涋']
洞: ['渦', '洞', '淈']
洟: ['溏']
洡: ['洓', '湅', '渿', '速']
洣: ['泳', '倈', '迭']
洤: ['洽']
津: ['濢', '澕']
洦: ['沔', '河', '活']
洧: ['侑']
洨: ['议']
洪: ['浂']
洭: ['诓', '浧']
洮: ['淣', '泚']
洯: ['罙']
洰: ['近', '讵', '沮', '叵', '污', '河', '洦', '活']
洱: ['洉']
洳: ['侞']
洴: ['涁', '浂']
洵: ['怐']
洶: ['淘']
洷: ['洹']
洸: ['汦']
洹: ['沮', '狟', '洷']
活: ['沔', '洰', '汚', '洦']
洼: ['娃']
洽: ['饴', '饸', '洤']
洿: ['渮', '淬']
流: ['沫', '流']
浂: ['洪', '洴']
浃: ['垁', '挾']
浇: ['饶']
测: ['侧', '測', '泐', '側']
浌: ['洩']
浏: ['泑']
浑: ['诨']
浔: ['洔']
浖: ['捋', '泘']
浘: ['沨']
浙: ['淅']
浚: ['渙', '漤', '涘']
浞: ['促', '滛']
浟: ['敟', '淑']
浠: ['沸', '稀']
浡: ['侓']
浢: ['迌', '涚', '饾']
浣: ['涴', '淀']
浥: ['洅']
浧: ['浬', '洭']
浨: ['沬', '沫', '俫', '淙']
浬: ['湮', '浧', '涅']
浯: ['俉']
浰: ['洌']
浲: ['捀', '偉']
浳: ['湆', '湂']
浴: ['俗', '治']
浶: ['淬']
海: ['疴']
浹: ['泫']
浻: ['涸', '泂', '涧']
涁: ['彤', '洴']
涂: ['湅', '涑', '涤']
涃: ['湘']
涄: ['恗', '澚']
涅: ['浬', '湼']
涇: ['洆', '烴']
消: ['诮', '俏']
涊: ['涩']
涋: ['洝']
涍: ['瘁']
涑: ['滦', '溾', '湅', '涂', '涞', '溁', '涷', '涤']
涒: ['语', '侰', '焐', '涺']
涔: ['侺', '沣']
涖: ['泄']
涗: ['恱']
涘: ['渘', '浚']
涙: ['淭', '淚']
涚: ['汫', '浢', '沇']
涛: ['渏', '湷']
涞: ['溾', '涑', '溁', '淶']
涠: ['淍', '湡']
涣: ['漺', '淡', '渓']
涤: ['滦', '涂', '涑']
涥: ['悙', '淬']
涧: ['浻', '涸', '泂']
涨: ['漲']
涩: ['淫', '涊', '俓']
涪: ['倍', '缶']
涬: ['淖']
涯: ['涶']
涰: ['渨']
涱: ['瀤']
液: ['滖']
涴: ['浣', '淀']
涵: ['洄']
涶: ['涯']
涷: ['涑']
涸: ['個', '浻', '泂', '涧']
涹: ['淩', '溇']
涺: ['涒', '居']
涻: ['泄']
涼: ['淙']
涽: ['逎', '湏', '湣', '澑']
涾: ['湆', '偣']
淀: ['涴', '浣']
淁: ['淎']
淅: ['浙']
淆: ['凊']
淈: ['漍', '洞', '湄', '洞']
淉: ['溗', '湶', '课']
淊: ['滔']
淋: ['淋']
淍: ['澗', '调', '淜', '涠']
淎: ['漳', '捧', '淁']
淐: ['湧', '渴']
淑: ['浟']
淒: ['瀁', '溸', '捿', '瀇']
淔: ['渲', '禃', '滇', '演']
淕: ['淦', '滢']
淖: ['涬', '逌', '俥', '洚']
淘: ['洶']
淙: ['涼', '浨']
淚: ['涙', '淭']
淛: ['溂', '俐']
淜: ['測', '滆', '湖', '淍', '倗']
淞: ['湁']
淠: ['涀', '湂']
淡: ['渓', '涣']
淣: ['洮']
淥: ['濚', '渘', '溧']
淦: ['滻', '淕']
淩: ['澆', '渎', '溇', '漠', '涹']
淪: ['淪']
淫: ['侳', '俓', '涩']
淬: ['洿', '浶', '猝']
淭: ['谏', '涙', '淚']
淮: ['渵']
淯: ['塆', '渏', '濟', '滀']
淰: ['谂']
淳: ['谆', '谉', '摔']
淴: ['滺']
淶: ['徠', '涞']
淸: ['滒']
淾: ['隶']
渃: ['洛', '洛']
渄: ['俳']
清: ['惰', '漳', '倩', '潃']
渆: ['瀏']
済: ['浐']
渊: ['漰']
渌: ['濴']
渍: ['湱']
渎: ['漺', '淩', '湙']
渏: ['淯', '倚', '徛', '涛']
渐: ['漸']
渓: ['淡', '渶', '洖', '湲', '涣']
渕: ['測']
渘: ['濚', '淥', '渌', '溧', '涘']
渙: ['澳', '浚']
渚: ['诸']
渜: ['凕', '湨', '瀷', '溟']
渞: ['湝']
渡: ['滻']
渢: ['潳']
渣: ['溲', '濱']
渥: ['偓']
渦: ['洞', '洞']
渧: ['谛']
渨: ['涰']
温: ['溢', '湿', '逞']
渫: ['灤']
測: ['侧', '测', '惻', '泐', '渕', '淜', '側']
渮: ['洿']
渲: ['淔', '儐', '演', '湞']
渴: ['淐', '偈']
渶: ['湙']
渺: ['湫']
渼: ['渫']
渾: ['潬']
渿: ['潦', '漴', '漺', '洡', '溘']
湁: ['淞']
湂: ['湏', '澚', '滘', '淠']
湄: ['煝', '淈']
湅: ['洓', '漺', '涂', '涑', '洡']
湆: ['煯', '涾', '偣', '浳']
湇: ['淌']
湊: ['瀁', '溱', '溴']
湋: ['媁']
湎: ['洏']
湏: ['涽', '湂']
湑: ['滑', '湒']
湒: ['湑']
湓: ['溢']
湖: ['淜']
湘: ['涃']
湙: ['漆', '漺', '渶', '湥', '渎']
湜: ['溭']
湝: ['渞']
湞: ['渲', '浈', '漓', '慎']
湟: ['漥']
湠: ['漛']
湡: ['倜', '涠']
湢: ['惺', '煏', '滘']
湣: ['涽', '溍']
湥: ['傸', '湙']
湧: ['淐']
湨: ['垻', '儑', '渜', '澯', '溟']
湩: ['漌', '滉', '遣']
湪: ['濙', '像']
湫: ['渺']
湭: ['煪']
湮: ['浬']
湰: ['谨', '潼']
湱: ['連', '渍']
湲: ['溭', '渓', '洖']
湳: ['漓']
湶: ['渁', '溸', '淉']
湷: ['澊', '涛']
湹: ['漚']
湼: ['隉', '涅']
湿: ['温']
満: ['渽']
溁: ['涑']
溂: ['潮', '俐', '淛']
溄: ['澤']
溆: ['漃']
溇: ['淩', '涹']
溈: ['媯']
溉: ['概']
溋: ['濫']
溍: ['逎', '僭', '湣']
溏: ['遍', '洟', '濇']
溑: ['逍']
溓: ['槏', '澡']
準: ['荸', '率']
溗: ['淉']
溘: ['渿']
溝: ['媾']
溟: ['渜', '潩', '湨']
溢: ['温', '湓', '谥']
溤: ['馮']
溥: ['憳', '澊']
溦: ['媺', '澉']
溧: ['濚', '渘', '搮', '淥']
溬: ['獇']
溭: ['湲', '湜']
溯: ['瀏']
溰: ['迼', '瀆']
溱: ['湊', '獉', '凑']
溳: ['儧']
溴: ['湊']
溷: ['漍']
溸: ['瀁', '湶', '塐', '淒', '瀇', '嫊']
溻: ['傝']
溾: ['涑']
滀: ['淯', '漓', '滝', '瘄']
滃: ['傟']
滄: ['澢', '潱', '搶']
滆: ['帰', '淜']
滇: ['淔', '漳', '演', '濱']
滈: ['稿', '澫']
滋: ['滧']
滍: ['溃', '隑']
滎: ['熒']
滑: ['滑', '傊', '湑']
滒: ['淸']
滔: ['洄', '淊']
滕: ['榺']
滖: ['潦', '漺', '液']
滘: ['湢', '湂']
滚: ['滾', '漃']
滛: ['浞', '傜', '徭']
滝: ['滀']
滞: ['滯']
滠: ['澋']
滢: ['淕', '递', '漜']
滥: ['濫']
滦: ['涑']
滧: ['滋', '潋']
滨: ['嫔']
滪: ['濒', '澦']
滬: ['滜', '澺']
滭: ['濞', '漻']
滯: ['滞', '澇']
滰: ['煷']
滶: ['澈', '潎']
滺: ['淴']
滻: ['渡', '淦', '淕']
滾: ['澭', '偯', '滚']
漀: ['檕']
漂: ['徱', '濡', '澤', '瀤']
漃: ['滚', '溆']
漅: ['澲', '摷']
漆: ['湙']
漍: ['湄', '淈', '溷']
漏: ['漏']
漐: ['槷', '淾']
漓: ['湳', '湞', '滀']
演: ['淔']
漕: ['愭']
漘: ['濆', '潳', '渢']
漚: ['週', '混', '熰', '湹']
漛: ['潻', '湠']
漜: ['滢']
漝: ['潪']
漠: ['淩']
漣: ['瀢', '褳', '漠']
漤: ['浚']
漥: ['湟']
漧: ['漸', '濣']
漨: ['澾', '漣']
漬: ['漹', '濡', '瀆', '濆', '灒', '潰']
漮: ['溸', '溴', '瀇', '潒']
漯: ['澋', '漴', '傫']
漰: ['渊']
漱: ['潡']
漳: ['滇', '清', '俸', '淎']
漴: ['渿', '漯']
漵: ['瀲', '潄', '潊', '潋']
漷: ['槨']
漸: ['漧', '渐', '濣']
漹: ['濡', '傿', '漬']
漺: ['漆', '潦', '洓', '滖', '湅', '渎', '渿', '湙', '涣']
漻: ['滭']
漿: ['奬']
潁: ['颕', '頴', '穎']
潃: ['清']
潄: ['漵', '瀨', '潋']
潇: ['溗']
潊: ['漵']
潋: ['漵', '瀲', '潄', '滧']
潎: ['滶']
潐: ['穛']
潓: ['濛']
潔: ['瀥', '瀠']
潕: ['嫵']
潙: ['爲']
潚: ['澽', '澞', '瀘']
潜: ['澘', '濇']
潝: ['澹']
潡: ['漱', '激']
潣: ['僩']
潤: ['澗']
潦: ['滖', '渿']
潧: ['溜', '澛']
潩: ['溟']
潪: ['漝']
潫: ['濕']
潬: ['渾', '偅']
潭: ['谭', '濥']
潮: ['溂']
潰: ['澢', '潱', '灒', '漬']
潱: ['滄', '潰']
潳: ['漘', '渢']
潶: ['灢', '嫼']
潻: ['漛']
潼: ['湰', '着', '撞']
潽: ['瀂']
澂: ['徽']
澃: ['澩']
澄: ['嬁']
澆: ['淩']
澇: ['滞', '滯']
澈: ['徹', '滶']
澉: ['溦']
澊: ['溥', '竴', '湷']
澋: ['儤', '滠', '洖', '漯']
澑: ['逎', '涽']
澕: ['津', '濢', '濞']
澖: ['濶']
澗: ['僴', '潤', '淍']
澘: ['潜']
澚: ['涄', '湂']
澛: ['潧']
澞: ['瀘', '潚']
澟: ['灢', '潩', '凜']
澡: ['灤', '濼', '缲', '溓']
澢: ['滄', '灒', '潰', '濬', '擂', '澐']
澤: ['溄', '漂']
澦: ['滪', '濒']
澧: ['撎', '瀅', '潢']
澩: ['澃']
澫: ['滈']
澭: ['滾']
澮: ['獪']
澯: ['湨']
澲: ['漅']
澳: ['渙']
澴: ['遀']
澹: ['谵', '潝', '濵']
澺: ['潦', '燱', '滬']
澻: ['嬘']
澽: ['據', '澞', '瀘', '潚']
澾: ['漣']
澿: ['濚', '濛', '濋']
激: ['潡']
濁: ['襡']
濃: ['瀟', '擃']
濄: ['撾', '谜', '流', '過']
濅: ['灚', '灠']
濆: ['瀆', '膹', '潰', '漘', '濯', '漬']
濇: ['瀋', '潜', '溏']
濋: ['澿', '濛']
濑: ['櫴']
濒: ['滪', '澦']
濕: ['潫', '隰']
濘: ['擰', '漥']
濙: ['濴', '澳', '湪']
濚: ['澿', '溧', '淥']
濛: ['澿', '濴', '濋']
濜: ['嬧']
濞: ['滭', '滉']
濟: ['淯', '渀']
濡: ['漹', '漬', '漂']
濢: ['津', '澕']
濣: ['漸', '漧', '瀚']
濤: ['瀟', '嬦', '濾', '濾', '灊', '禱']
濦: ['淰']
濫: ['滥']
濬: ['澢']
濯: ['灈', '忂']
濰: ['灕']
濱: ['滇', '洝', '渣']
濲: ['瀔']
濳: ['瀅']
濴: ['渌', '濙', '濛']
濵: ['澹']
濶: ['澖', '灍']
濹: ['瀖']
濼: ['灤', '渫', '澡']
濾: ['濾', '濤', '懅']
濿: ['灡', '漡', '滠']
瀁: ['溸', '湊', '淒']
瀂: ['潽']
瀅: ['澧', '邊', '濳', '潢']
瀆: ['溰', '濆', '漬']
瀇: ['溸', '爌', '淒', '漮']
瀋: ['濇']
瀌: ['爊', '濓']
瀍: ['灋']
瀏: ['溯', '渆']
瀐: ['瀸']
瀔: ['濲', '瀫']
瀖: ['懽', '濹']
瀘: ['澞', '潚']
瀙: ['瀨', '瀬']
瀚: ['瀭', '濣']
瀟: ['濃']
瀠: ['瀥', '潔']
瀢: ['灗', '漣', '灐']
瀤: ['涱', '漂']
瀥: ['瀠', '潔']
瀨: ['瀙', '潄']
瀩: ['瀬', '襭']
瀫: ['瀔']
瀬: ['瀩', '瀙']
瀭: ['瀚']
瀯: ['攚']
瀲: ['漵', '潋']
瀷: ['灢', '渜']
瀸: ['谶', '瀐']
瀼: ['孃', '欀']
瀾: ['灡']
灁: ['灟', '灛']
灂: ['皭']
灄: ['欇']
灈: ['忂', '濯']
灊: ['濤', '灜']
灋: ['瀍']
灍: ['澖', '濶']
灐: ['濴']
灒: ['澢', '潰', '漬']
灔: ['灧']
灕: ['濰']
灗: ['瀢']
灙: ['攩']
灚: ['濅']
灛: ['灁']
灜: ['灊']
灟: ['灁']
灠: ['灚', '濱', '濅']
灡: ['襽', '濿', '瀾']
灢: ['澟', '澳', '潩', '瀷', '潶']
灤: ['渫', '濼', '澡']
灧: ['灔']
火: ['人']
灬: ['罒', '仒', '心']
灮: ['允', '尣', '夰']
灯: ['奵', '钉', '訂']
灲: ['汋']
灳: ['匄', '勼']
灴: ['矼', '订', '烇']
灶: ['汁', '劜']
灸: ['炙']
灹: ['玕', '忹', '虴', '仟', '託']
灺: ['他']
灻: ['荧']
灼: ['钓', '炉']
灾: ['文']
灿: ['诎']
炂: ['烚']
炃: ['盆']
炆: ['恔', '炊']
炇: ['烄', '攸']
炉: ['灼']
炊: ['炆']
炋: ['紑']
炌: ['炕', '屼']
炏: ['炒', '烛']
炐: ['沣', '怑']
炑: ['炞']
炒: ['炏']
炓: ['烊']
炔: ['烄', '炴', '炫', '侠']
炕: ['炌', '鈧', '抭']
炖: ['烨']
炗: ['芜', '芖']
炘: ['岏', '蚚', '忦', '忻']
炙: ['灸']
炚: ['紞']
炜: ['伟']
炝: ['伧']
炞: ['炑']
炟: ['炣', '炬', '鉭', '抯', '烥', '烇']
炡: ['炷']
炣: ['炟', '胢']
炤: ['绍', '佋']
炥: ['煪', '柫']
炨: ['铊', '佗']
炩: ['狑', '坽', '伶', '烇']
炫: ['烗', '煫', '炔', '烠']
炬: ['狙', '烥', '炡']
炭: ['岽']
炯: ['烔', '焖', '焆', '烟', '熖']
炰: ['氚']
炲: ['怆', '恰', '怡', '烚', '佮', '炂', '铪', '殆']
炴: ['烄', '炔']
炶: ['怙']
炷: ['玣', '蛀', '拦']
炸: ['妦', '烨']
炾: ['怾', '況']
烀: ['烰', '泘']
烂: ['性', '纻']
烃: ['怪']
烄: ['炔', '炴']
烅: ['煪', '逈', '爏']
烇: ['恮', '侄', '炩', '灴']
烊: ['炓', '洋', '垟']
烋: ['依', '恷']
烌: ['烞', '惏']
烎: ['烮', '灵']
烑: ['焥']
烓: ['焓', '烴', '蛙']
烔: ['炯', '焆']
烕: ['威', '咸']
烖: ['哉']
烗: ['熕', '炫', '焳']
烙: ['焙', '熔', '烙']
烚: ['怆', '炲', '恰', '佮', '炂', '铪']
烛: ['炏']
烝: ['蒸']
烞: ['惏', '烌']
烟: ['炯']
烠: ['炫']
烤: ['焷']
烥: ['炬']
烨: ['炸']
烫: ['燙']
烮: ['炙', '烎']
烯: ['焍', '悕']
烰: ['烀', '伴']
烱: ['焹']
烳: ['俌']
烴: ['烓', '绖', '蛵']
烵: ['筠']
烷: ['焥']
烸: ['煂']
烺: ['悢']
烻: ['侹']
烾: ['塁']
焃: ['焼', '熵']
焅: ['诘']
焆: ['烔', '炯']
焊: ['娨', '皔']
焍: ['烯']
焐: ['语', '侰', '涒']
焑: ['悃', '焖']
焒: ['炪']
焓: ['焙', '烓']
焖: ['炯', '焑']
焙: ['熔', '烙', '焓', '愹']
焛: ['閛', '閕', '閞', '誾', '閱', '閩', '闇', '悶']
焜: ['煺', '惃', '煾']
焞: ['焷', '崞', '惇']
焠: ['猝']
焥: ['烷', '烑', '惋', '帵']
焩: ['燘', '诩']
焯: ['悼', '惮']
焴: ['媠', '錥', '熇', '请']
焵: ['煱', '惘', '熌']
焷: ['焞', '烤', '椑']
焸: ['爂', '焽', '煚']
焹: ['烱']
焺: ['煜']
焼: ['煷', '熵', '焃']
焽: ['焸', '煚']
焾: ['熄']
煁: ['偡']
煂: ['烸', '愅', '煊']
煃: ['煌']
煄: ['熡', '熦']
煆: ['縀']
煇: ['燀', '煾', '湒']
煈: ['熰', '爏']
煉: ['煉', '棟']
煊: ['煌', '熜']
煋: ['熘', '煨']
煌: ['煃', '熜']
煍: ['愀']
煏: ['湢']
煐: ['愥']
煒: ['燒', '憶', '徫', '椲']
煓: ['椯', '褍']
煕: ['熙']
煖: ['燰']
煙: ['熞']
煚: ['焸', '焽']
煛: ['燢']
煜: ['熎', '焺']
煝: ['湄']
煟: ['稩']
煢: ['禜']
煦: ['喣']
煨: ['偎', '煩', '崸']
煩: ['煨', '崸']
煪: ['烅', '炥', '湭']
煬: ['熡']
煯: ['湆', '偣']
煱: ['焵']
煴: ['慍']
煶: ['惿']
煷: ['焼', '熵', '滰', '愯', '熄']
煸: ['鳊']
煹: ['媾', '構']
煺: ['焜', '煾']
煻: ['糖', '糖', '熗']
煾: ['煇', '煺', '燖', '焜']
煿: ['傅', '燇', '博']
熀: ['悮', '熉', '愰']
熁: ['燲']
熄: ['煷', '焾', '熜']
熆: ['燱']
熇: ['禞', '焴', '镐']
熉: ['熀', '傊', '愪', '熕']
熌: ['燘', '焵']
熍: ['馆']
熎: ['谣']
熑: ['缣']
熒: ['滎']
熔: ['焙', '烙', '愹']
熕: ['熉']
熖: ['炯', '嫍']
熗: ['搶', '滄', '牄', '煻']
熘: ['煋']
熙: ['煕']
熚: ['燀', '熉']
熜: ['憁', '樬', '煊', '煌', '熄']
熞: ['煙']
熡: ['煬', '煄', '爘', '熺', '艛']
熢: ['燵']
熦: ['煄', '爉', '燿', '爠']
熩: ['燒', '憶']
熫: ['燑']
熭: ['賚']
熮: ['爡', '嵺']
熰: ['愝', '漚', '爏', '樞', '煈']
熲: ['颎']
熳: ['慢', '煶']
熵: ['煷', '焼', '焃']
熸: ['憯', '噆']
熹: ['霙', '嚞']
熺: ['熡', '憘', '瞦']
熽: ['燥', '爐', '爐']
熿: ['爔']
燀: ['煇', '熚']
燁: ['爃']
燂: ['憛']
燆: ['嬌']
燇: ['煿', '博']
燈: ['橙']
燉: ['燩']
燌: ['幘']
燎: ['燷', '燎']
燏: ['燗']
燐: ['燐', '橉', '僯']
燑: ['遠', '艟', '獞', '嫤', '懭', '幢', '熫']
燒: ['膮', '熩', '皢']
燔: ['襎', '嬏', '嶓', '橎']
燖: ['襑', '燯', '煾']
燗: ['燏', '爓', '爛']
燘: ['焩', '熌']
燙: ['烫']
燛: ['翜']
燝: ['爎']
燠: ['懊']
燡: ['嬕']
燢: ['煛']
燣: ['燺', '燥']
燤: ['燱']
燥: ['燣', '熽', '煠']
燨: ['嬟']
燩: ['燉']
燪: ['爙']
燯: ['燖']
燰: ['煖']
燱: ['熆', '澺', '燤']
燲: ['儥', '燿', '熁']
燴: ['禬']
燵: ['熢']
燷: ['爙', '燎', '燎']
燸: ['臑', '曘', '嬬', '襦']
燺: ['燣']
燼: ['爧']
燽: ['壔']
燾: ['蔶']
燿: ['熦', '燲', '懼', '爠']
爁: ['糮']
爂: ['焸']
爃: ['燁', '嶸']
爄: ['爤', '櫔', '糲']
爅: ['慬']
爈: ['爐', '爐']
爉: ['犣']
爊: ['瀌']
爌: ['瀇', '慷']
爍: ['煠', '爜']
爎: ['燝']
爏: ['熰', '慪', '愝', '煈']
爐: ['爈', '擄', '熽', '爐']
爒: ['鐐', '嫽']
爓: ['燗', '潣', '爛']
爔: ['爙', '熿', '爖']
爕: ['夑']
爖: ['爔']
爙: ['爔', '燷', '燪']
爛: ['撋']
爜: ['懽', '爍']
爟: ['孉']
爠: ['熦', '燿', '臞']
爣: ['曭']
爤: ['爄', '欗']
爧: ['燣', '燼']
爪: ['冚', '仈', '讥']
爫: ['乄', '亽']
爯: ['肙']
爲: ['潙']
父: ['乂', '乀', '又', '兊']
爼: ['飷']
爽: ['夹']
牃: ['谍', '媟']
牄: ['鎗', '熗', '獊']
片: ['兮', '厃']
版: ['舨']
牌: ['稗']
牏: ['牕']
牑: ['楄']
牔: ['膊', '賻']
牕: ['牏']
牜: ['衤', '扌']
牝: ['牤', '扑', '杧']
牞: ['朷']
牟: ['孕', '氒', '车']
牠: ['忚']
牡: ['籵', '杜']
牢: ['牢']
牣: ['初']
牤: ['牝', '柱', '杖', '杧']
牥: ['枋']
牦: ['柉', '扥']
牧: ['抆']
牨: ['坑', '抗', '柼']
物: ['粅', '肳']
牪: ['牸', '忡', '拄']
牮: ['柋']
牯: ['岾']
牲: ['独']
牴: ['抸']
牵: ['窐']
牸: ['牪', '挓']
牼: ['挃', '桱']
牽: ['寧', '挚']
牾: ['峿', '啎']
牿: ['犃', '拮', '悎']
犁: ['罦']
犃: ['牿']
犄: ['崎', '畸', '犗']
犅: ['棡']
犆: ['愃', '蝖']
犈: ['裷', '蜷']
犉: ['椁', '桍', '啍', '楟', '蜳']
犋: ['棂']
犏: ['糄']
犒: ['稿']
犕: ['鞴']
犗: ['犄']
犙: ['恀', '幓', '糝']
犝: ['嶂', '蟑', '穜', '徸']
犞: ['憍']
犡: ['禲']
犢: ['犡', '積', '襩']
犣: ['爉']
犥: ['懭', '儦']
犨: ['孼']
犪: ['巙']
犭: ['糹', '讠', '个', '丨']
犰: ['狁']
犲: ['犿']
犳: ['钓']
犴: ['扦', '杅']
犵: ['忔']
状: ['犾', '呔', '吠']
犸: ['玛']
犹: ['沋']
犺: ['妔', '秔']
犻: ['沛']
犾: ['状', '狄']
犿: ['犲']
狀: ['狀']
狁: ['犰']
狂: ['杠', '彺', '呸']
狃: ['妞', '鈕']
狄: ['犾']
狅: ['奷']
狉: ['狅']
狊: ['昊', '旱']
狌: ['泩', '独']
狎: ['钾']
狑: ['炩', '坽', '伶']
狓: ['被', '坡']
狕: ['坳']
狖: ['払', '抭']
狙: ['坥', '炬']
狜: ['钴']
狟: ['洹']
狠: ['猴']
狣: ['眺', '猐']
独: ['牲', '狌']
狯: ['狳']
狳: ['狯']
狸: ['锂']
狻: ['猣', '踆']
狼: ['狼', '踉']
猀: ['挱', '麨']
猁: ['琍']
猃: ['裣']
猄: ['弶', '猔']
猅: ['裶']
猆: ['斐', '菐', '奜', '葜']
猉: ['稘', '踑', '諆']
猍: ['睞']
猎: ['错']
猐: ['狣', '錓']
猓: ['堁']
猔: ['猄']
猗: ['锜']
猚: ['锥', '睢']
猜: ['掅', '皘']
猝: ['焠']
猣: ['狻']
猤: ['聧']
猦: ['颯']
猨: ['獧']
猬: ['猲']
猭: ['瑑', '堟']
猯: ['瑞']
猱: ['蹂']
猴: ['狠']
猶: ['揂']
猺: ['摇']
獀: ['獱']
獁: ['獝']
獇: ['溬']
獉: ['溱', '獷']
獊: ['鎗', '牄']
獌: ['獾']
獎: ['槳', '奬']
獐: ['獔']
獓: ['獥']
獔: ['獐']
獖: ['羵']
獗: ['橛']
獘: ['奬']
獛: ['墣']
獜: ['撛']
獝: ['瞲', '獁']
獞: ['谨', '玃', '瘼']
獠: ['撩']
獣: ['獻']
獤: ['墩']
獥: ['璬', '獓']
獧: ['猨']
獪: ['澮']
獯: ['鑂']
獰: ['擰', '矃', '鑏']
獱: ['殯', '獀']
獲: ['獾']
獳: ['擩']
獷: ['鑛', '獉', '彍']
獹: ['攎']
獺: ['襰']
獻: ['歗', '獣', '戲']
獼: ['镾']
獾: ['獌', '獲']
玅: ['耖']
率: ['莩', '斈', '率', '孪', '準', '率']
玉: ['匛', '坕']
玌: ['化']
玎: ['饤', '汀']
玐: ['扒', '竌', '玑']
玑: ['玐', '竌', '玩']
玒: ['仕', '讧', '让', '仜', '佂']
玓: ['仢', '珀']
玕: ['盰', '灹', '纤', '玗', '坏', '矸', '仟']
玖: ['玫']
玗: ['盰', '旴', '玕', '盱', '矸']
玘: ['记']
玛: ['犸']
玜: ['珆', '玧']
玟: ['玫']
玢: ['盼']
玣: ['住', '件']
玧: ['玜']
玨: ['珏']
玫: ['玖', '玟']
玭: ['玱', '妣']
环: ['汗']
玱: ['珨', '玭']
玷: ['砧', '佑']
玹: ['珠', '珐']
玺: ['窰']
玼: ['珧']
珀: ['玓']
珃: ['珘']
珆: ['冾', '抬', '玜']
珈: ['跏']
珏: ['玨']
珒: ['箄']
珔: ['琂']
珘: ['琂', '珃']
珜: ['祥']
珞: ['珞']
珠: ['咮', '玹', '硃']
珧: ['垗', '玼']
珨: ['硆', '玱', '孡']
珫: ['琓']
珱: ['琝']
珸: ['珺']
珺: ['珸']
珼: ['孭']
珿: ['瑆']
琁: ['琔']
琂: ['珔', '珘']
理: ['理']
琉: ['硫', '琔', '硫']
琍: ['猁']
琐: ['璸', '顼']
琑: ['鞝']
琓: ['琬', '珫']
琔: ['琉', '琁']
琛: ['堔', '墚']
琝: ['珱']
琟: ['骓']
琡: ['埱']
琣: ['琦', '瑢']
琦: ['琣']
琧: ['墾']
琨: ['顼', '瑥']
琬: ['琓']
琮: ['琼']
琹: ['楘']
琼: ['琮']
琽: ['瑢', '堵', '瑵']
琾: ['璆']
琿: ['璋']
瑆: ['珿']
瑇: ['埥']
瑈: ['瑹', '瑮']
瑏: ['瑢']
瑑: ['琭', '堟', '猭']
瑕: ['瑖']
瑖: ['瑕']
瑗: ['瑷']
瑘: ['珊']
瑞: ['踹']
瑢: ['琣', '瑏', '琽']
瑣: ['顼']
瑥: ['琨']
瑩: ['縈', '瑩']
瑭: ['磄', '璉']
瑱: ['璸']
瑵: ['琽']
瑷: ['叆']
瑹: ['瑈']
瑺: ['璫']
瑻: ['璫', '瓆', '瓄']
璄: ['璋']
璆: ['瑻', '琾', '瓄']
璇: ['瓌']
璈: ['璬']
璉: ['瑭', '摙', '塳']
璋: ['璄', '琿']
璎: ['璖']
璖: ['瓅', '璎']
璗: ['重']
璜: ['璸']
璝: ['璳', '瓉']
璞: ['瑣']
璤: ['瓖']
璩: ['瓌']
璫: ['瑺', '瑻']
璬: ['獥', '璈']
璳: ['璝', '瓉', '璘']
璴: ['瓘']
璵: ['礖']
璸: ['琐', '瑱', '璜']
璽: ['墾', '蠆', '鞪', '藁', '墨', '藳']
璾: ['躋']
瓁: ['顼']
瓂: ['壒']
瓄: ['璆', '瑻']
瓅: ['璖']
瓆: ['瓒', '瑻']
瓉: ['璝', '璳', '璘']
瓋: ['璉']
瓌: ['璇', '璩', '壞']
瓕: ['鑋']
瓖: ['璤']
瓗: ['驨']
瓘: ['璴']
瓚: ['璒']
瓣: ['辦']
瓦: ['耳', '互']
瓫: ['贫']
瓮: ['瓷']
瓱: ['瓸']
瓶: ['甁']
瓷: ['瓮']
瓸: ['瓱']
瓾: ['瓺']
瓿: ['敨']
甁: ['瓶']
甅: ['廛']
甖: ['罌']
甘: ['并']
甚: ['畗']
生: ['尘']
産: ['痓']
田: ['彐', '四', '工']
由: ['巾']
申: ['牢']
甸: ['匇']
画: ['圉', '囤', '囩']
甼: ['早', '果']
甾: ['笛']
甿: ['癿', '盳']
畂: ['攺', '畎']
畄: ['凷']
畉: ['畋']
畋: ['畉']
畍: ['畛', '畂']
畎: ['畂']
畔: ['筓', '笄']
畕: ['畐', '啚']
畗: ['寔', '畠', '甚']
畛: ['畍']
畠: ['畗']
畡: ['畯']
畢: ['罼']
畣: ['盒']
略: ['略']
畧: ['零']
畩: ['饻']
畫: ['薑']
畭: ['赊', '馀']
畯: ['畡', '睃']
異: ['異']
畴: ['畸']
畵: ['霪']
畷: ['蝃', '腏']
畸: ['崎', '畴']
畾: ['瞐']
疂: ['謈']
疄: ['辚']
疇: ['嚋', '儔']
疊: ['籑']
疋: ['迃']
疍: ['豎']
疎: ['疏']
疏: ['巯', '疎']
疐: ['霊', '責']
疒: ['疖', '匚', '只', '丁', '匸']
疓: ['疜']
疕: ['庀']
疘: ['迗', '疝', '迁']
疙: ['疮', '疱']
疚: ['疥']
疜: ['疠', '疝']
疝: ['疜', '疘', '仜', '疪']
疟: ['疳']
疠: ['疜']
疣: ['氐']
疥: ['疚']
疦: ['症']
疧: ['疭', '疯']
疨: ['疬', '病']
疩: ['瘁']
疪: ['疝']
疬: ['痈', '病', '疨']
疭: ['疧', '痧']
疮: ['疙']
疯: ['痗', '疧']
疱: ['疙']
疲: ['速', '痠', '瘀']
疳: ['疟']
疴: ['海']
疵: ['痊']
疶: ['痼', '疸']
疸: ['疶']
疹: ['癈', '痤', '癮', '疵']
疺: ['痫']
疻: ['痐']
疽: ['癨', '痙', '痤', '痊', '痽', '痘']
疾: ['筷', '疫']
疿: ['癇', '痘', '瘐']
痂: ['痱', '瘛', '瘋']
痃: ['痰']
病: ['疬', '痈', '疺', '疨']
症: ['疦', '痘', '茬']
痈: ['病']
痊: ['疽', '癨', '痙', '瘞', '痤', '痽', '疵']
痋: ['痰']
痌: ['痼']
痍: ['瘜', '癀']
痎: ['瘶']
痏: ['痡', '痢', '瘄']
痐: ['疮', '疻']
痑: ['痰']
痒: ['倿']
痓: ['瘂']
痔: ['侼']
痕: ['瘣', '痙', '痺', '瘱', '瘞', '癊', '瘐']
痘: ['疽', '症', '瘐', '疿']
痙: ['疽', '瘣', '痕', '瘞', '瘿', '痊']
痚: ['瘧']
痛: ['痡', '瘸', '痭', '瘤', '癵']
痜: ['瘚']
痞: ['痨', '瘔', '痉', '癌', '瘖']
痠: ['疲', '瘟', '瘨']
痡: ['痛', '瘏', '痏']
痢: ['瘌']
痣: ['违']
痤: ['疽', '痊', '痽', '疹']
痦: ['瘔', '噟']
痧: ['疭']
痩: ['痻', '癅']
痫: ['癤', '瘤', '癵', '瘾', '瘑']
痬: ['瘟']
痭: ['痸', '痛', '癖', '瘸', '痢', '癵']
痮: ['瘳', '痋']
痯: ['僒', '瘄']
痰: ['痜', '痃', '痋']
痱: ['痂']
痲: ['瘓']
痳: ['瘓']
痸: ['瘮', '癥', '痭', '痢']
痹: ['瘻']
痺: ['庳', '痕']
痻: ['痩', '癥', '癯']
痼: ['疶', '痾', '痌', '瘩']
痽: ['疽', '癨', '痤', '痊']
痾: ['癆', '痌', '痼']
痿: ['瘘', '瘳', '傻']
瘀: ['疲']
瘁: ['痸', '疨', '疩']
瘂: ['痓']
瘄: ['痯', '瘖', '滀', '痏']
瘅: ['癀']
瘆: ['痕', '瘿', '瘐']
瘈: ['擙']
瘉: ['瘌']
瘊: ['療', '瘵', '療']
瘋: ['瘣', '癙', '瘧', '痙', '癔', '痂', '痍', '瘜', '癀', '瘙']
瘌: ['瘉', '痢']
瘎: ['癨', '瘱', '瘞']
瘏: ['瘮', '痡', '痛']
瘐: ['瘦', '痕', '痘', '疿', '倹']
瘑: ['痫']
瘒: ['癉']
瘓: ['痲', '痳']
瘔: ['痞', '痦']
瘖: ['痞', '瘤', '庴', '瘄']
瘗: ['癜', '瘥', '癢', '瘳']
瘘: ['痿', '瘳']
瘙: ['瘧', '瘜', '癕', '瘛', '瘡', '癀']
瘚: ['痜']
瘛: ['癫', '痂', '癒', '癀', '瘙']
瘜: ['癙', '痍', '癋', '瘡', '癀', '瘋']
瘝: ['傣']
瘞: ['痙', '瘱', '痕', '痊', '瘎']
瘟: ['痓', '痬', '痠']
瘡: ['瘧', '瘜', '癒', '癀', '瘙']
瘢: ['癈', '癮', '癁']
瘣: ['痙', '痕']
瘤: ['痫', '痛', '瘖']
瘥: ['癢', '瘗']
瘦: ['癨', '癮', '瘐']
瘧: ['癒', '瘡', '瘙', '瘋']
瘨: ['痠', '癍']
瘩: ['痼']
瘪: ['癮']
瘭: ['瘰']
瘮: ['痸', '癈', '癯', '瘏']
瘰: ['瘭']
瘱: ['痕', '瘞', '癮', '瘎']
瘳: ['癜', '瘘', '痿', '瘗', '瘻', '癒', '癲', '癡', '痮']
瘴: ['癬', '癔', '癀']
瘵: ['療', '瘊', '療']
瘶: ['痎']
瘸: ['痛', '癯', '痭', '癵', '癘']
瘺: ['癄']
瘻: ['痹', '瘳', '癒', '癡']
瘼: ['廙']
瘽: ['瘝']
瘾: ['痫', '癵']
瘿: ['瘆', '痙', '廋', '瘱', '癬', '痕', '癊']
癀: ['癔', '瘴', '痍', '瘜', '瘛', '瘡', '瘙']
癁: ['癈', '癮', '瘢', '癯', '癘']
療: ['瘵', '瘊', '療']
癃: ['癜']
癄: ['瘺']
癅: ['痩', '痻', '癯']
癆: ['痾']
癇: ['癊', '疿', '癎']
癈: ['癮', '瘢', '癁', '疹']
癉: ['癢', '瘒']
癊: ['癇', '痕', '癮']
癋: ['億', '癙']
癍: ['瘨']
癎: ['癇', '癙']
癒: ['瘻', '瘛', '瘡', '癚']
癔: ['瘴', '癀']
癕: ['瘙']
癖: ['痭']
癘: ['癁', '癯', '瘸']
癙: ['癋', '瘜', '癎']
癚: ['癒']
癛: ['廩', '癝']
癜: ['瘗', '瘳', '癒', '癲']
癝: ['癛']
癞: ['癩', '癩']
癡: ['瘻', '瘳']
癢: ['瘥', '瘗']
癤: ['痫', '癥', '癵']
癥: ['痸', '痻', '癤', '癵']
癨: ['疽', '瘦', '痊', '痽', '癮', '瘎']
癩: ['癩', '癞']
癫: ['瘛', '癲']
癬: ['廯', '瘿', '瘴']
癮: ['瘪', '癨', '瘱', '瘦', '癈', '瘢', '癁', '癯', '癊', '疹']
癯: ['瘮', '癮', '痻', '癁', '瘸', '癵', '癘', '癅']
癰: ['癫', '癲', '癱']
癲: ['癜', '癫', '瘳']
癴: ['療', '療']
癵: ['痫', '痛', '癥', '癯', '瘸', '痭', '癤', '瘾']
癸: ['旲']
癹: ['畟']
白: ['仁']
百: ['仾']
癿: ['甿']
皁: ['枲', '萃', '享']
皃: ['兖']
皅: ['蚆', '肥']
皇: ['草', '卓']
皈: ['岋', '阪']
皋: ['皐']
皌: ['袜']
皎: ['绞', '较']
皏: ['峅']
皐: ['稟', '夆', '奉', '車', '皋', '傘', '車', '臬']
皓: ['祰']
皔: ['娨', '焊']
皖: ['睆']
皘: ['猜', '蜻', '襀', '掅', '嫧']
皙: ['晢', '哲', '晳']
皚: ['媸']
皜: ['缟', '禞', '塙']
皞: ['皥', '暲']
皟: ['嬇', '幘', '樻']
皡: ['皥', '障', '唪']
皢: ['徺', '隢', '膮']
皥: ['皡', '皞']
皫: ['臕']
皭: ['灂']
皯: ['酐']
皶: ['皼', '皷']
皷: ['皶']
皸: ['駊']
皹: ['緷', '齳', '餫']
皺: ['麬']
皼: ['皶']
皿: ['囬']
盆: ['炃']
盇: ['泴']
盈: ['蒕']
盋: ['茎']
盒: ['盬', '畣']
盕: ['泴']
盘: ['盚']
盚: ['盘']
盦: ['盫']
盧: ['盧']
盫: ['盦']
盬: ['盒']
盭: ['鍳']
目: ['巨']
盰: ['玕', '玗', '盱', '矸']
盱: ['釪', '旰', '玗', '矸', '旴']
盲: ['窘']
盳: ['甿']
盶: ['阮', '阮']
相: ['枂']
盼: ['玢']
眄: ['陌', '眧', '呵']
眅: ['阪']
眆: ['肪', '昉']
眈: ['躭']
眉: ['厝']
眔: ['罘']
眕: ['胗', '险']
眗: ['眴', '昫']
眙: ['孡', '跆']
眛: ['眯', '昧', '眜']
眜: ['眯', '昧', '陎', '眛']
眠: ['氓']
眡: ['秪', '胝']
眢: ['冑', '胄', '督']
眣: ['趺', '趹']
眧: ['眄']
眩: ['睞']
眬: ['咙', '昽', '哤']
眭: ['晆']
眮: ['睭']
眯: ['昧', '眛', '眜', '眿']
眱: ['咦', '陳']
眴: ['咰', '绚', '眗']
眵: ['昣', '眇']
眺: ['狣']
眼: ['跟', '硍']
眿: ['眯']
睄: ['销']
睅: ['睜']
睆: ['睨', '皖']
睇: ['瞵', '睎']
睋: ['硪', '娥', '哦']
睍: ['睗']
睎: ['睇']
睏: ['瞘']
睐: ['瞭']
睓: ['晪']
睔: ['腀', '踚', '陯']
睕: ['睨', '鋺', '晼']
睖: ['陵']
睗: ['睍', '晹']
睙: ['錑']
睛: ['晴']
睜: ['睟', '睅']
睞: ['眩', '猍']
睟: ['膟', '錊', '睜']
睡: ['娷']
睢: ['猚', '碓']
督: ['眢']
睥: ['聹', '髀', '聛']
睦: ['稑']
睨: ['睆', '睕', '晲']
睩: ['騄']
睭: ['眮']
睮: ['喻']
睰: ['蹃']
睶: ['暙']
睽: ['瞁']
瞁: ['睽']
瞃: ['腯']
瞆: ['瞋']
瞈: ['嗡', '暡']
瞉: ['縠', '毂', '穀']
瞋: ['瞆', '填']
瞍: ['矎']
瞎: ['磍']
瞏: ['褜']
瞐: ['晶', '鸁', '聶']
瞔: ['磧', '瞦', '歵']
瞕: ['暲']
瞖: ['瞥', '朁']
瞗: ['鴡', '鳿', '鴙', '鴖']
瞘: ['膒', '睏', '隁']
瞙: ['瞸', '暯']
瞚: ['跠']
瞜: ['瞶', '矈']
瞝: ['眱', '瞒']
瞞: ['暪']
瞟: ['膘', '缥', '嘌']
瞢: ['萺', '賫', '蘮']
瞤: ['瞷']
瞥: ['瞖', '曫', '暋']
瞦: ['瞔', '嬉', '暿']
瞧: ['噍', '礁']
瞩: ['嘱']
瞫: ['矒', '镡', '曋']
瞭: ['睐']
瞮: ['隞', '撤']
瞯: ['矙']
瞱: ['曄']
瞲: ['獝']
瞳: ['曈']
瞵: ['睇', '暽']
瞶: ['矉']
瞷: ['瞤']
瞸: ['瞙']
瞹: ['曖']
瞻: ['贍', '曕', '矎']
瞼: ['睃']
瞾: ['壆', '罜', '茞']
瞿: ['雹', '髺']
矂: ['缲', '臊', '躁']
矃: ['獰', '嚀', '擰']
矄: ['曛']
矅: ['曜', '曮']
矆: ['嚄']
矈: ['瞜', '陽', '矏']
矉: ['瞶', '暄']
矋: ['矙']
矎: ['瞻', '瞍']
矏: ['矈']
矐: ['矔', '曤', '嚁']
矑: ['曥']
矒: ['瞫']
矔: ['矐']
矕: ['彎']
矖: ['躧']
矙: ['睱', '瞯', '矋']
矚: ['曯']
矝: ['粆']
矡: ['躩']
矦: ['俟', '侯']
矮: ['蜲']
矯: ['轎']
矰: ['竲', '橧']
矴: ['矼', '奵']
矸: ['盰', '旴', '旰', '玕', '纤', '玗', '盱']
矼: ['矴', '舡', '灴']
矿: ['砣', '砊']
砂: ['硅']
砄: ['砆']
砆: ['跌', '砄', '硖', '轶']
砊: ['砣', '矿']
砋: ['耻']
砌: ['碙']
砍: ['肷']
砎: ['研', '砏']
砏: ['砎', '纷']
砐: ['硫', '礆']
砓: ['砹']
砕: ['碎']
砖: ['碕']
砗: ['硣', '碎', '砱']
砙: ['砚']
砚: ['砜', '硬', '砙']
砜: ['砚']
砝: ['砿']
砞: ['硤', '硃', '破']
砠: ['租', '豠']
砡: ['硁', '纴']
砢: ['妸', '胢', '跒']
砣: ['砊', '矿']
砧: ['玷', '跕']
砮: ['硩']
砱: ['砗']
破: ['砞']
砹: ['砓']
砾: ['硢', '硕', '硍']
砿: ['砝']
硁: ['轻']
硃: ['珠', '砞']
硅: ['跬', '磑', '砂']
硆: ['珨']
硍: ['硕', '砾', '眼']
硎: ['鉶']
硐: ['碿', '酮']
硑: ['帡']
硒: ['哂', '晒']
硔: ['碄', '晎']
硕: ['砾', '碩']
硖: ['磲', '跌']
硗: ['骁', '磽']
硘: ['砌', '硱']
硛: ['硓']
硞: ['碚']
硟: ['诞']
硠: ['踉']
硡: ['硫', '碂']
硢: ['碂', '砾']
硣: ['砗', '碑']
硤: ['聗', '砞']
硥: ['礎']
硦: ['哢']
硨: ['晫']
硩: ['砮']
硪: ['娥', '睋']
硫: ['碛', '硫', '琉', '砐', '硡']
硬: ['砚']
硱: ['碅', '硘']
硲: ['碏']
硷: ['殓']
硹: ['碰']
硺: ['碛']
硼: ['磵', '礀']
碁: ['荟']
碂: ['硢', '硡', '踪', '磙']
碃: ['碡', '聙']
碅: ['硱']
碇: ['埞']
碎: ['砗', '砕']
碐: ['碜']
碑: ['硣', '脾']
碓: ['睢']
碕: ['砖']
碗: ['磇', '踠']
碙: ['砌']
碚: ['踣', '硞']
碜: ['碐', '磣']
碝: ['磲']
碟: ['磜', '殜']
碡: ['磧', '碃']
碣: ['竭']
碨: ['磪']
碩: ['硕']
碰: ['硹', '磁']
碲: ['蹄']
碶: ['禊', '褉']
碹: ['磄', '殖']
碼: ['磶']
碿: ['硐']
磁: ['碰', '稵']
磂: ['礌']
磄: ['瑭', '碹']
磇: ['碗']
磈: ['騩', '隗']
磊: ['磊']
磌: ['蹎']
磍: ['碦', '瞎']
磏: ['稴']
磑: ['硅']
磕: ['磙']
磗: ['膊', '賻']
磘: ['暚']
磙: ['磕', '碂']
磚: ['磹', '膞']
磜: ['碟']
磝: ['嗷']
磞: ['塴']
磟: ['醪']
磣: ['碜']
磤: ['礰']
磥: ['磲', '礘', '礤']
磦: ['醥', '礹']
磧: ['瞔', '碡', '歵']
磨: ['廗', '唐']
磪: ['碨']
磭: ['礪', '礪']
磯: ['禨']
磰: ['缮']
磲: ['磥', '硖', '碝', '礤']
磳: ['赠', '贈']
磴: ['礸']
磵: ['礀', '硼']
磶: ['碼', '礍']
磷: ['撛']
磸: ['礢', '磺']
磹: ['驔', '磚', '曋']
磺: ['礢', '磸']
磻: ['磻']
磼: ['襍', '礦']
磽: ['蹺', '硗']
磿: ['唇']
礀: ['磵', '硼']
礁: ['噍', '礘', '瞧']
礂: ['嬉', '暿']
礅: ['暾']
礆: ['砐', '驗']
礌: ['磂', '礍']
礍: ['礌', '磶']
礎: ['硥']
礏: ['曗']
礓: ['砸']
礔: ['擗']
礖: ['璵']
礘: ['磥', '礁']
礝: ['礵', '礭']
礟: ['礮']
礢: ['磸', '磺']
礤: ['磥', '磲']
礦: ['磌', '擴', '磼']
礧: ['蠝']
礪: ['磭', '礪']
礭: ['礵', '礶']
礮: ['礟']
礰: ['礹', '磤']
礵: ['礝', '礭']
礶: ['礭', '驩']
礸: ['磴']
礹: ['礰', '欕', '磦']
示: ['无', '巟']
礻: ['忄']
礼: ['祁', '补']
礽: ['祀', '杌']
社: ['壮', '圵']
礿: ['袀']
祀: ['枟', '礽']
祁: ['补', '礼']
祂: ['衪']
祄: ['妎', '吤', '衸', '袕']
祅: ['扷', '衽', '祗']
祆: ['袄']
祇: ['衹', '袛']
祈: ['杬', '杭']
祉: ['訨']
祊: ['钫', '妨', '坊']
祌: ['袖', '衶', '肿']
祍: ['圲', '钎', '秆', '枉', '忏', '托', '扜', '枖']
祎: ['袆']
祏: ['拓', '拓']
祑: ['裌', '铗']
祒: ['栢', '怊']
祓: ['被', '坺', '袯']
祔: ['祢']
祕: ['秘', '袐']
祖: ['租', '枑']
祗: ['秖']
祙: ['秣']
祚: ['柞']
祛: ['柹', '衭']
祜: ['怙', '袷', '岵']
祝: ['柷']
祟: ['樂']
祠: ['祤']
祢: ['袮', '祔', '祑']
祣: ['祺']
祤: ['祠']
祥: ['垟', '咩']
祦: ['禊']
票: ['昙']
祩: ['跦']
祫: ['韐', '袷']
祬: ['秷']
祰: ['皓']
祱: ['帨', '棁', '哾', '衭', '娧']
祳: ['裖', '振']
祴: ['裓']
祵: ['裲', '梱', '裍', '稇', '袻', '稛']
祷: ['铸', '禎', '德', '禟', '梼', '裿']
祹: ['蜪']
祺: ['祣', '褀']
祻: ['棞', '锢', '裮']
祼: ['祿', '裸']
祽: ['捽', '悴']
祾: ['裬', '婈', '绫', '睖']
祿: ['祼', '裸']
禀: ['蔂', '蔓', '稁', '楶', '槀']
禁: ['苇']
禂: ['裯', '裥', '婤', '禍', '稠']
禃: ['淔', '檳', '植']
禄: ['禔', '褆']
禅: ['褌', '禈']
禇: ['蝫', '绪']
禈: ['襅', '禅', '褌']
禊: ['碶', '祦', '褉']
禍: ['裯', '裥', '稠', '禂']
禎: ['祷', '揁']
禐: ['褑', '嗳', '援']
禒: ['褖', '缘']
禓: ['揚']
禔: ['禄', '褆']
禕: ['褘', '椲']
禖: ['褋']
禘: ['褅']
禙: ['褙']
禛: ['嫃']
禜: ['煢']
禞: ['缟', '皜', '襓', '熇', '塙', '镐', '禛']
禟: ['糖', '糖', '祷']
禠: ['搋']
禡: ['榪']
禢: ['褟', '塌']
禣: ['鐏', '搏', '缚']
禤: ['搨', '褟']
禧: ['櫓', '櫓', '糦']
禨: ['磯']
禪: ['襌']
禫: ['槱', '撢', '橝']
禬: ['襘', '燴']
禭: ['襚']
禯: ['禓']
禰: ['櫺']
禱: ['櫄', '嬦', '濤']
禲: ['犡']
禳: ['忀', '纕', '镶']
禶: ['囋', '襸']
禿: ['秀', '秃']
秀: ['禿']
秃: ['禿']
秄: ['衽', '秠']
秅: ['秄']
秆: ['圲', '钎', '屽', '豻', '扞', '扜', '祍', '枖']
秈: ['籼']
秉: ['美']
秊: ['氒', '乖', '季', '秊']
秎: ['吩', '鈖']
秐: ['耘']
秒: ['秧', '秭']
秓: ['跂', '秣', '秩']
秔: ['犺', '钪', '蚢']
秕: ['秖', '枇']
秖: ['秕', '祗']
秘: ['袐', '祕']
秙: ['咕', '詁', '轱']
秚: ['姅', '裆']
秛: ['翄']
租: ['祖', '豠', '砠']
秠: ['秄']
秢: ['呤']
秣: ['祙', '秓']
秤: ['芹']
秥: ['站', '點']
秦: ['菒', '奏', '奉']
秧: ['秒', '映']
秨: ['咋', '怍']
秩: ['玞', '秓', '昳']
秪: ['袛', '眡']
秬: ['岨', '秳', '柜', '柤', '岠']
秭: ['秒']
秮: ['稓', '孡', '跆', '眙']
秱: ['稠']
秳: ['秬']
秵: ['裀', '稇', '駰', '稛']
秶: ['棃', '楽', '卖', '粊', '某', '棸']
秷: ['祬']
秸: ['祰']
秹: ['栣', '銋']
移: ['秒']
秼: ['跊']
秿: ['補', '铺']
稀: ['浠', '桸']
稁: ['蔂', '禀', '豪', '葉', '葉', '槀']
稂: ['锒', '蜋']
稃: ['坢']
稄: ['唆', '竣']
稇: ['秵', '裍', '稛', '祵']
稉: ['绠']
稑: ['穔', '淕', '睦']
稖: ['殕']
稗: ['牌']
稘: ['猉', '踑']
稙: ['稸']
稚: ['谁']
稛: ['梱', '秵', '裍', '稇', '祵']
稜: ['掕', '穣', '稷']
稞: ['捰']
稟: ['草', '皐', '車', '卓', '車']
稠: ['裯', '禍', '秱', '禂']
稡: ['蜶']
稤: ['婛', '练', '錝']
稩: ['煟', '谓']
稪: ['複']
稫: ['蝠', '褔', '福']
稴: ['搛', '磏']
稵: ['磁']
稷: ['稜']
稸: ['稙']
稺: ['搱']
稾: ['藝']
稿: ['滈', '穑']
穀: ['鷇', '縠', '瞉', '豰']
穅: ['穬', '穕']
穇: ['椮']
積: ['瞔', '犢', '歵']
穎: ['顈', '潁', '頛', '颖']
穏: ['穩']
穐: ['穪']
穑: ['稿']
穒: ['鴑', '鴌']
穔: ['横', '稑']
穕: ['穅']
穖: ['機']
穗: ['穩']
穜: ['徸']
穞: ['惽', '樌']
穟: ['嬘']
穠: ['穏']
穣: ['稜']
穦: ['檳']
穧: ['臍']
穩: ['穗', '穏']
穪: ['穐', '襧']
穬: ['穲', '穅']
穯: ['榗']
穲: ['襹']
穴: ['六', '亣', '丸']
空: ['乲']
穻: ['窄', '穾', '窂', '柰', '寀']
穼: ['筞', '罙', '宎']
穾: ['奕', '桨', '実', '奖', '寀', '穻']
突: ['宷', '宎']
窂: ['毕', '穻']
窄: ['穻']
窌: ['窕', '窬', '茆']
窐: ['蛰', '罣', '牵']
窒: ['筀']
窖: ['锽']
窗: ['實', '恵']
窘: ['盲']
窙: ['孳']
窞: ['窩']
窠: ['寧', '寧', '袬']
窧: ['罩']
窨: ['罯']
窩: ['窞']
窬: ['窌']
窭: ['崣', '薆']
窰: ['玺']
窳: ['庼']
窶: ['霋']
窼: ['寧', '嶪']
窽: ['竅']
窿: ['嶐']
竅: ['窽']
竈: ['鼃']
竉: ['巃']
立: ['立']
竌: ['飢', '玐', '釠', '玑']
竎: ['弄', '弄', '弃']
竏: ['轩', '訐', '吀', '紆', '虷', '奷', '纡']
竐: ['杸']
竑: ['纮']
竓: ['蚝']
竔: ['姸', '岍', '妍', '蚈', '竕', '咞']
竕: ['衯', '竔', '粉', '訜']
竗: ['纱']
站: ['秥']
竚: ['咛', '聍']
竛: ['昤', '唥']
竞: ['莞']
竟: ['苣']
章: ['韋', '輂', '拿']
竡: ['咟', '姡']
竣: ['唆', '稄']
竨: ['晫']
竭: ['餲', '蝎', '碣']
端: ['喘', '腨']
竱: ['慱']
竲: ['矰', '缯', '橧']
竳: ['嬁']
竴: ['澊']
竷: ['贛']
竸: ['鏡']
竽: ['竿']
竿: ['笒', '学', '竽']
笁: ['壬']
笄: ['筓', '畔']
笅: ['筊', '筮']
笆: ['笘']
笇: ['卡']
笊: ['笕', '汃']
笋: ['等', '策']
笎: ['筅']
笏: ['筍']
笑: ['筴']
笒: ['竿', '笭', '岑']
笓: ['笽']
笕: ['笊']
笛: ['甾', '笾']
笝: ['箘']
笠: ['笠']
笤: ['筈', '箁']
笫: ['筇']
笭: ['笒']
笵: ['箔']
笼: ['筄']
笽: ['笓']
笿: ['筨']
筀: ['窒']
筄: ['笼']
筅: ['笎']
筆: ['攣']
筇: ['笫']
筈: ['笤']
等: ['策', '笋']
筊: ['笅', '筮']
筍: ['笏']
筓: ['畔', '笄']
策: ['等', '笋']
筘: ['筎']
筙: ['実']
筜: ['笪']
筞: ['穼']
筠: ['烵']
筤: ['簹']
筧: ['霓', '篼', '篦']
筨: ['筶', '笿']
筩: ['篱']
筭: ['筹', '篣']
筮: ['筊', '笅']
筳: ['篞']
筴: ['笑']
筶: ['筨']
筷: ['疾']
筸: ['箪']
筹: ['筭']
筺: ['篞']
筽: ['茛']
箁: ['笤']
箂: ['朿']
箄: ['珒', '茑']
箆: ['篦']
箇: ['箘']
箈: ['箔']
箋: ['荛']
箑: ['箜']
箔: ['箈', '笵']
箕: ['筭']
箘: ['箇', '笝']
管: ['庯']
箥: ['籢']
箪: ['筸']
箸: ['簹']
箼: ['蔧']
箽: ['籃']
篃: ['簂']
築: ['筿']
篌: ['墣']
篒: ['籥']
篗: ['隻']
篞: ['筺']
篡: ['簒']
篢: ['賲', '簀']
篣: ['筭']
篦: ['箆', '篰']
篫: ['搫']
篰: ['篦']
篱: ['筩']
篻: ['冥']
篼: ['筧']
篿: ['簟']
簀: ['篢']
簅: ['崖']
簆: ['筪']
簉: ['跾']
簋: ['簠']
簍: ['寠']
簎: ['籕']
簑: ['簔']
簒: ['篡']
簔: ['簑']
簗: ['橜']
簟: ['篿']
簠: ['簋']
簤: ['籫']
簧: ['賃']
簹: ['筤', '箸']
簾: ['簾']
籆: ['賁', '籰']
籉: ['霻']
籏: ['簱']
籑: ['疊']
籕: ['簎']
籖: ['籤']
籘: ['虅']
籝: ['籯']
籠: ['籠']
籢: ['箥', '籨', '笯']
籤: ['籖']
籥: ['篒']
籨: ['籢']
籩: ['邏']
籫: ['贙', '簤']
籮: ['蘿', '蘿']
籯: ['籝']
籰: ['籆', '矍']
籵: ['牡', '粍', '杜']
籷: ['粁', '扦', '杄', '杅', '杆', '杯', '杔']
籸: ['粉']
籹: ['敉']
籼: ['粙', '秈']
籽: ['杍', '枉']
籾: ['紉']
粁: ['犴', '籷', '衧', '扦', '杄', '杆', '杯', '杔']
粂: ['楽', '粊']
粃: ['纰', '址']
粄: ['版']
粅: ['糋', '粚', '肳', '物']
粆: ['矝']
粇: ['吭', '粒', '衸', '袕']
粉: ['竕', '籸']
粊: ['粂', '粜', '槼', '秶']
粋: ['粹']
粍: ['籵', '枆']
粐: ['鈩']
粑: ['杷']
粒: ['粒', '忼', '粇']
粓: ['粗']
粕: ['拍', '岶']
粖: ['帓']
粗: ['粓', '靻', '爼']
粘: ['拈']
粙: ['籼']
粚: ['粅']
粜: ['粊', '栾']
粟: ['栗', '栗']
粡: ['烔']
粢: ['栥', '粲', '紊']
粭: ['袷', '帢']
粯: ['頪']
粰: ['粆']
粱: ['梁', '梁']
粲: ['粢', '橤']
粳: ['頪']
粹: ['椊', '粋']
粺: ['崥']
精: ['輤', '糟', '婧']
糁: ['糝', '糭', '糉']
糄: ['斒']
糇: ['糨', '帿']
糈: ['揟', '糬', '壻', '蝑']
糉: ['崚', '糭', '糁']
糋: ['粅']
糌: ['揝']
糏: ['糑']
糐: ['鎛']
糑: ['糏']
糓: ['鷇', '轂']
糖: ['糖', '禟', '煻']
糗: ['螑']
糙: ['慥']
糛: ['隚']
糝: ['幓', '糭', '糁', '犙']
糞: ['窠']
糟: ['槽', '嶆', '艚', '精']
糠: ['槺']
糢: ['模', '橂']
糣: ['糬']
糥: ['檽', '燸', '糦']
糦: ['禧', '糥']
糧: ['糧']
糩: ['櫓', '櫓']
糪: ['繴']
糬: ['糣', '糈']
糭: ['糝', '糉']
糮: ['轞', '爁']
糯: ['隭', '蠕']
糲: ['爄']
糴: ['糶']
糵: ['蘖', '蓂', '蘗', '蘂']
糶: ['糴']
糷: ['躪']
糹: ['豸']
糺: ['紇', '礼']
糿: ['杒', '紉']
紀: ['屺', '紇', '記']
紃: ['細']
約: ['魡', '馰', '絇']
紅: ['纴']
紆: ['吀', '虷', '奷', '竏', '纡']
紇: ['糺', '紀', '屹']
紈: ['紋']
紉: ['糼', '糿', '籾', '魛']
紊: ['粢', '梥']
紋: ['紈', '紌', '紗', '絞', '絖']
紌: ['紋', '訧']
紎: ['紩', '紌', '紗', '絖', '舦', '統', '紪']
紐: ['紐', '紝', '杻']
紑: ['紝', '岯', '炋', '綷']
紒: ['給', '紎', '紋', '紗', '絖']
純: ['縨', '結', '紣', '紘']
紗: ['紩', '鈔', '紎', '紶', '紋', '絯', '絓', '絖', '緂', '紷']
紘: ['純', '結', '絘', '絋']
紛: ['岎', '魵', '紜']
紝: ['飪', '鈓', '紐', '阡', '紑']
紞: ['炚']
紟: ['紾']
紡: ['防', '舫']
索: ['察']
紣: ['純', '紾', '緋']
紤: ['釿', '訢']
紦: ['帊']
紨: ['紲']
紩: ['妷', '紶', '紗', '絯', '絖']
紪: ['紎', '維', '緃', '繌', '統']
紬: ['絀', '蚰', '铀', '絹']
細: ['絧', '綑', '紃']
紱: ['緃', '柭', '紴']
紲: ['紨']
紴: ['紱', '綊', '紻', '飨']
紶: ['紩', '紗', '絞', '絯', '絓']
紷: ['絝', '綬', '終', '綂', '紾', '紗']
紹: ['轺']
紻: ['絃', '綊', '絩', '綟', '緽', '紴']
紼: ['鉘', '鮄']
紾: ['終', '絊', '紣', '紷']
紿: ['給', '絟']
絀: ['綒', '紬']
絁: ['絡']
終: ['絶', '緫', '絳']
絃: ['綊', '絿', '絯', '紻', '統', '緂', '綕']
絅: ['絧', '絪', '絗']
絆: ['経', '綷']
絇: ['姰', '鮈']
絈: ['袙']
絉: ['絿']
絊: ['紾']
絋: ['絞', '紘']
経: ['絰', '絚', '經']
絍: ['綎']
結: ['純', '紘']
絑: ['株', '線', '袜']
絓: ['綻', '紶', '紗', '絯', '統', '緂', '綕']
絔: ['絬', '紦']
絖: ['銃', '紩', '綂', '続', '紗']
絗: ['絅', '絪']
絘: ['紘']
絙: ['綛', '絚', '經']
絚: ['絙', '経', '經']
絛: ['儵']
絝: ['縍', '緒', '綂', '緫', '梬', '紷']
絞: ['綬', '紶', '絯', '絋']
絟: ['紿', '紪']
絡: ['絁']
絢: ['蚼']
絣: ['綐', '跰', '蜕']
絤: ['綰', '綇']
給: ['絟', '桧', '紿', '紒']
絧: ['絅', '綑', '細']
絨: ['純', '緘']
絩: ['繎', '絻', '紱', '紻']
絪: ['絅', '絗']
絬: ['絔']
絯: ['紩', '紶', '紗', '絞', '絓', '統', '緂', '綕']
絰: ['経', '絕', '經']
統: ['絃', '綊', '絯', '絓', '繌', '綕', '紪']
絳: ['終', '絶', '締']
絶: ['終', '綂', '絳']
絷: ['縶', '挚']
絸: ['規', '緄']
絹: ['蜎', '綢', '紬', '綱']
絻: ['絩']
絾: ['緘']
絿: ['絃', '綊', '絉', '綕', '婡']
綀: ['練', '練', '線', '鋉', '縭', '鍊']
綂: ['綬', '絖', '紷']
綄: ['綩']
綅: ['縨', '縜']
綆: ['緷', '緉']
綇: ['絤']
綊: ['絃', '絿', '紻', '統', '紴', '綕']
綋: ['綻', '緫']
綍: ['緈', '綼']
綎: ['脡', '絍']
綐: ['絸']
綑: ['婟', '絧', '細']
綒: ['絀']
經: ['絙', '経', '絚']
綕: ['絃', '繀', '綊', '紶', '繽', '絯', '絓', '統', '紴']
綖: ['挺', '蜒']
綗: ['網', '綢', '綱']
続: ['絖']
綛: ['絙']
綜: ['綡']
綝: ['崊']
綞: ['緮', '緛', '綵']
綟: ['綾', '紻']
綠: ['綠']
綡: ['凉', '凉', '綜', '繱']
綢: ['網', '綗', '綱', '絹']
綣: ['縗', '緿']
綩: ['綄', '縮']
綫: ['纔']
綬: ['綂', '絞', '紷']
維: ['紪']
綰: ['綼', '絤']
綱: ['網', '綗', '綢', '絹']
網: ['綗', '綢']
綳: ['繝']
綵: ['棎', '棌']
綶: ['棵', '縕']
綷: ['縡', '絆']
綸: ['錀']
綺: ['緽']
綻: ['綋', '縋']
綼: ['綍', '綰']
綽: ['緙', '銉']
綾: ['綾', '錂', '綟', '縝', '緽']
綿: ['艊']
緀: ['繶', '緁', '縤']
緁: ['繕', '緀', '縛']
緂: ['紗', '絯', '絓']
緃: ['紱']
緄: ['緦', '絸', '緶']
緇: ['縮']
緈: ['綍']
緉: ['緦', '綆']
緊: ['繁']
緋: ['紣']
緍: ['婚', '銽']
緎: ['掝']
総: ['繎']
緒: ['絝', '縋', '緖']
緔: ['縎']
緕: ['縇']
緖: ['緒', '鳝']
緘: ['絾', '槭', '縅', '絨', '缄']
緙: ['繟', '縪']
線: ['繚', '絑', '縯', '綀', '練']
緛: ['綞']
緝: ['緄', '縎']
緟: ['繥', '繮']
締: ['縖']
緢: ['錨']
緣: ['緿']
緤: ['鑠']
緦: ['緄']
編: ['媥', '艑']
緪: ['縆']
緫: ['終', '綋']
緬: ['媔', '栭']
緭: ['媦']
緮: ['鰒', '縵', '繌', '綞']
緯: ['繚', '縗', '繞']
緱: ['餱']
練: ['練', '綀', '錬', '線', '鋉', '縭']
緵: ['綏', '鲮']
緶: ['緄']
緷: ['縪', '縎', '皹', '綆', '餫']
緹: ['鍉']
緼: ['縕']
緽: ['綾', '繽', '紻', '綟', '綺']
緿: ['綣', '繮']
縀: ['煆', '鰕']
縁: ['絑', '縿']
縅: ['縬', '緘']
縆: ['緪']
縇: ['馗']
縈: ['瑩', '瑩']
縉: ['榗']
縊: ['繕']
縋: ['緒', '綻']
縍: ['絝']
縎: ['緔', '緷', '緝']
縏: ['繋', '撀']
縑: ['鎌', '鰜', '繰']
縓: ['纈']
縔: ['繰']
縕: ['纒', '綶', '媼', '緼', '繓']
縖: ['締', '縇']
縗: ['繚', '綣', '緯', '縝', '繞']
縘: ['縯', '縝']
縙: ['繱', '綡']
縚: ['絒']
縛: ['榑', '緁']
縜: ['綅']
縝: ['繚', '綾', '縯', '縗', '縘']
縟: ['媷', '繏']
縠: ['鷇', '瞉', '穀', '豰']
縡: ['繂', '膟', '懧', '綷']
縤: ['縥', '繶', '緀']
縥: ['臻', '縤']
縦: ['縱']
縧: ['纝']
縪: ['繟', '緙', '緷']
縫: ['鐽', '繨']
縬: ['媙', '縅']
縭: ['繬', '綀', '練', '線', '纔']
縮: ['緇', '綩']
縯: ['縘', '線', '縝']
縱: ['縦']
縲: ['繮']
縳: ['鱄']
縴: ['繚']
縵: ['緮']
縶: ['絷']
縷: ['縿', '纉', '繢']
縸: ['繅', '鏌', '繕']
縹: ['繻']
縻: ['鷹', '檿']
績: ['續', '繙', '繡', '繷']
縿: ['縁', '縷']
繀: ['綕']
繁: ['緊']
繂: ['縡', '檸', '蟀']
繃: ['鏰', '磞']
繅: ['縸']
繆: ['繟', '嫪']
繈: ['繦']
繊: ['旘']
繋: ['縏']
繌: ['緮', '繽', '絓', '統', '紪']
繍: ['繣', '繡']
繎: ['総', '絩', '繺']
繏: ['縟']
繐: ['繢', '繮']
繓: ['縕']
織: ['纖', '纎', '軄', '繼']
繕: ['繬', '縸', '縊', '緁']
繖: ['繳']
繗: ['鏻', '繽', '纘', '鱗']
繙: ['繬', '緟', '績']
繚: ['鐐', '縗', '鑔', '線', '縝']
繝: ['綳']
繞: ['縗', '緯']
繟: ['縪', '緙']
繠: ['繴']
繡: ['繻', '彇', '繍', '績', '繷']
繢: ['繐', '纉', '縷', '緽']
繣: ['繍']
繤: ['裹', '璽', '蔘', '蕞', '蟇', '藳']
繥: ['緟', '橲', '繷', '譆']
繦: ['繈']
繨: ['縫', '鐽', '纙']
繪: ['縷']
繫: ['擊', '轚']
繬: ['縫', '轖', '繙', '練', '繕', '縭']
繭: ['虅', '葳', '蒧', '茝']
繮: ['緟', '縲', '繐', '縘', '纙', '緿', '纆']
繯: ['嬛']
繰: ['縔', '縑', '褬']
繱: ['縙', '綡']
繳: ['繖']
繴: ['糪', '繠']
繶: ['緀', '縤']
繷: ['繥', '繡']
繸: ['繾']
繺: ['繎']
繻: ['縹', '繍', '繡']
繼: ['纒', '織']
繽: ['纘', '繌', '繗', '緽', '綕']
繾: ['繸']
纄: ['鑝']
纅: ['濼', '鑠', '觻']
纆: ['縲', '繮']
纇: ['頷', '頽']
纈: ['纐', '縓']
纉: ['鑚', '縷', '繢']
纊: ['鑣']
續: ['讀', '檮', '績']
纍: ['雧', '櫐']
纎: ['織']
纏: ['躔']
纐: ['纈']
纒: ['繼', '縕']
纔: ['綫', '纙', '縭']
纕: ['禳']
纖: ['纎', '鑯', '織']
纗: ['驨']
纘: ['繽', '攢', '鐨', '攅', '繗']
纙: ['繨', '纔', '繮']
纝: ['縧']
纟: ['釒', '乡']
纡: ['钚', '讦', '奸', '竏']
纣: ['討']
纤: ['玕', '矸']
纥: ['吃']
约: ['抣', '妁', '蚐', '虳']
纩: ['扩', '圹']
纪: ['妃']
纫: ['訒', '虭', '鱽']
纬: ['结']
纭: ['妘']
纮: ['竑']
纯: ['帥', '旽']
纰: ['粃', '豼', '鈚']
纱: ['竗']
纲: ['钢']
纴: ['饦', '紅', '砡']
纶: ['纷', '纹', '岮', '轮']
纷: ['砏', '纶', '鈖']
纹: ['纶', '妏']
纺: ['仿', '鈁']
纻: ['烂']
纽: ['组', '妞', '鈕']
纾: ['经']
绀: ['钳']
练: ['婛', '缭', '稤']
组: ['殂', '鉏']
终: ['鉖']
绊: ['绖', '姅']
绋: ['昲', '拂']
绍: ['佋', '炤']
绎: ['择']
经: ['纾']
绐: ['垥', '坮', '峆', '鉿', '拾', '拾']
结: ['纬']
绔: ['绪']
绕: ['挠', '统']
绖: ['姪', '烴', '绊']
绘: ['捡']
给: ['纶', '哈', '咍']
绚: ['眴', '徇']
绞: ['皎']
统: ['銃', '绕']
绡: ['娋', '梢', '陗']
绤: ['鋊']
绨: ['挮', '銻']
绩: ['缜', '馈']
绪: ['禇', '绔', '蜡']
绫: ['裬']
续: ['缤']
绰: ['掉']
绲: ['婫']
绳: ['蝇']
维: ['谁']
绵: ['棉']
绸: ['裯']
绻: ['腃']
综: ['腙', '绽']
绽: ['综', '锭']
绾: ['嫆', '绺']
绿: ['娽', '缇']
缀: ['娺']
缁: ['鲻']
缄: ['槭']
缅: ['缛']
缇: ['绿']
缊: ['榅', '腽']
缋: ['缎']
缎: ['缋']
缐: ['缤', '缭', '鳈']
缒: ['膇']
缓: ['锾']
缔: ['媂']
缕: ['镂']
编: ['褊']
缘: ['禒']
缙: ['瑨']
缚: ['赙', '禣']
缛: ['缅']
缜: ['搷', '绩']
缟: ['皜', '禞', '塙', '镐']
缠: ['健']
缡: ['摛']
缢: ['膉', '賹']
缣: ['隒', '膁']
缤: ['镔', '缐']
缥: ['瞟']
缧: ['鏍', '螺']
缨: ['撄']
缪: ['豂']
缭: ['鐐', '练', '缐', '膫']
缮: ['鳝', '磰']
缯: ['竲', '增', '贈']
缱: ['儙']
缲: ['嬠', '矂', '橾', '澡']
缴: ['躈']
缵: ['躜']
缶: ['倍', '涪']
缷: ['卸']
罂: ['罌']
罄: ['罌']
罈: ['撢']
罊: ['髺']
罌: ['罄', '甖']
罐: ['鑵']
罒: ['灬']
罔: ['岡']
罘: ['眔']
罙: ['穼', '呆']
罜: ['壆', '瞾']
罠: ['冕']
罣: ['窐']
罥: ['雷', '雷']
罦: ['単']
罧: ['槑']
罩: ['窧']
罯: ['窨']
罵: ['駡']
罹: ['罹']
罺: ['龑', '棗']
罼: ['畢', '蕈']
羀: ['耆']
羅: ['羅']
羋: ['卆', '苓', '某', '芩']
美: ['秉']
羑: ['夌', '羙']
羕: ['譱']
羖: ['羧']
羙: ['羑', '莢']
羛: ['養']
羟: ['陉', '径']
羡: ['蓑', '衰']
羣: ['曓', '舝', '拿', '槀', '鞏']
羧: ['羖']
義: ['譱']
羪: ['娘']
羬: ['媙']
羯: ['褐']
羳: ['播']
羵: ['鱝', '獖', '幩']
羸: ['赢', '贏', '鸁', '蠃', '驘']
羹: ['藳']
羺: ['臑', '壖', '襦']
羿: ['弄', '弄']
翄: ['秛']
翊: ['蛡']
翋: ['翂']
翌: ['昱']
翓: ['詡']
翜: ['燛']
翝: ['翱']
翣: ['蔢', '窭']
翨: ['翼', '蠒']
翬: ['費']
翯: ['鬻']
翱: ['翝']
翵: ['鶸', '鵐', '鶋']
翶: ['翸']
翸: ['翶']
翼: ['翨']
翿: ['翾']
老: ['老']
者: ['春']
耆: ['羀']
耋: ['董', '蘲']
而: ['冋']
耎: ['奐', '旲', '荑']
耏: ['耐']
耐: ['耏']
耒: ['宰', '芜']
耓: ['釘']
耖: ['玅']
耗: ['魹']
耘: ['転', '秐']
耛: ['耠']
耝: ['跙']
耟: ['距']
耠: ['耛']
耤: ['錯']
耧: ['耬']
耫: ['樍']
耬: ['耧', '鏤']
耮: ['撈', '鐒']
耻: ['趾']
耼: ['驵']
耿: ['聅', '联']
聀: ['戢']
聃: ['聕']
聄: ['职']
聅: ['联', '聗', '耿']
聆: ['駖']
聉: ['聥']
职: ['聄', '聦']
聍: ['竚', '咛']
聎: ['聯']
聐: ['耾']
联: ['聅', '耿']
聖: ['蝁', '蟄']
聗: ['聅', '硤']
聘: ['騁']
聙: ['碃']
聛: ['豍', '睥']
聝: ['駴']
聞: ['闍', '閬', '閯', '關', '闐', '閼']
聡: ['聪', '聦']
聢: ['跿', '諚']
聥: ['聉']
聦: ['职', '聡']
聧: ['猤', '暌']
聪: ['聦', '聡']
聯: ['聯']
聲: ['聳', '聻']
聳: ['聲']
聵: ['瞶']
聶: ['瞐']
職: ['膱', '嬂']
聸: ['舚']
聹: ['睥']
聻: ['聲', '斊']
聾: ['謦', '聾', '讆']
聿: ['革']
肀: ['枣']
肊: ['肛']
肋: ['助', '劤', '肋']
肍: ['肘', '肮']
肐: ['趷']
肑: ['朐']
肓: ['宥']
肔: ['脸', '脑', '胿', '阤']
肗: ['妝', '股']
肘: ['肍', '財']
肙: ['爯', '谔']
肛: ['豇']
肝: ['歼']
股: ['脮', '肗']
肢: ['肤', '胠', '胺']
肣: ['鈐']
肤: ['脏', '肢', '朕', '胠']
肥: ['皅']
肦: ['朌']
肧: ['胚']
肨: ['胖']
肪: ['眆']
肮: ['肍']
肰: ['肷']
肱: ['胠']
肳: ['胕', '胞']
肵: ['斨']
肷: ['砍', '肰', '欢', '欣']
肸: ['胫']
肼: ['胼', '腁']
肿: ['胪']
胀: ['胝', '胱']
胂: ['朏']
胃: ['冐', '宵']
胄: ['冑', '眢']
胅: ['妷', '胘', '胦']
胇: ['腆', '朓']
胊: ['豞']
胍: ['腿', '膽']
胎: ['脃', '貽']
胑: ['脘']
胓: ['脟']
胖: ['肨']
胗: ['眕']
胘: ['舷', '胲', '胅', '胠', '胦']
胚: ['肧']
胛: ['钾']
胜: ['貹', '脃']
胝: ['胀', '眡', '貾']
胞: ['肳']
胠: ['肢', '朕', '胘', '肤', '肱']
胢: ['妸', '砢', '跒']
胦: ['妷', '陜', '脥', '胅', '胘']
胨: ['陈']
胩: ['脥', '胱']
胪: ['肿']
胫: ['肸']
胭: ['胴', '膕']
胮: ['舽']
胯: ['舿']
胰: ['腠', '膜', '腴']
胱: ['脥', '膑', '胩']
胲: ['赅', '胘', '脮', '賅']
胳: ['賂', '賂']
胴: ['胭']
胵: ['脛', '脞']
胶: ['脏', '胿']
胺: ['肢']
胼: ['肼', '腁', '骿']
胿: ['脑', '螣', '肔', '胶']
脃: ['朑', '胜']
脅: ['骨']
脆: ['陒']
脉: ['脒']
脍: ['臉', '腲']
脑: ['胿', '脦', '膽', '肔']
脒: ['脉', '腂', '腺']
脖: ['饽', '脾']
脗: ['朏']
脘: ['胑', '院']
脙: ['賕']
脛: ['胵']
脝: ['腔', '膟', '朜']
脞: ['朑', '胵']
脠: ['鯅']
脡: ['綎']
脣: ['暦', '曆', '曆']
脥: ['胅', '胱', '胩', '胦']
脦: ['脑']
脧: ['賐']
脨: ['媡', '腺']
脪: ['螣']
脫: ['腉', '脱']
脮: ['胲', '股']
脱: ['蜕', '脫']
脸: ['险', '肔']
脺: ['崪']
脻: ['腠']
脽: ['陮', '婎']
脾: ['陴', '碑', '脖']
腀: ['陯', '睔']
腁: ['胼', '肼']
腂: ['騬', '脒', '婐']
腃: ['绻']
腅: ['賧']
腆: ['腓', '媵', '胇']
腈: ['靖', '锖', '臆', '鲭', '膧']
腉: ['脫']
腋: ['腴']
腍: ['胱']
腎: ['青', '督', '眢']
腏: ['畷']
腐: ['扈', '庸']
腑: ['膔']
腒: ['艍', '鋸']
腓: ['腆', '朓']
腔: ['脝']
腖: ['膝', '陳']
腙: ['综']
腟: ['膣']
腠: ['脻', '胰']
腡: ['踻']
腤: ['堷']
腧: ['腑']
腨: ['端']
腩: ['揇']
腮: ['腯', '膄']
腯: ['瞃', '腮']
腰: ['臎']
腲: ['脍']
腴: ['腋', '胰']
腺: ['腂', '脨', '脒']
腻: ['膩']
腽: ['缊']
腾: ['膡']
腿: ['螁', '胍']
膀: ['嫎']
膁: ['隒', '賺', '臊']
膃: ['媼']
膄: ['腮', '艘']
膅: ['膖', '膳']
膆: ['臆', '臃']
膇: ['膬', '缒']
膉: ['賹', '缢']
膊: ['磗', '賻', '镈', '牔']
膋: ['罃']
膌: ['膾']
膏: ['咠']
膑: ['胱']
膒: ['瞘', '腦']
膔: ['腑']
膕: ['胭']
膖: ['膅']
膘: ['瞟']
膛: ['塍']
膝: ['腖']
膞: ['磚']
膟: ['睟', '縡', '脝', '朜']
膡: ['腾', '謄']
膣: ['腟']
膤: ['謄']
膦: ['隣', '隣', '臢']
膧: ['臆', '朣']
膩: ['腻']
膪: ['塍', '膛']
膫: ['嫽', '缭']
膬: ['膇']
膭: ['臏', '殨']
膮: ['臆', '隢', '皢']
膯: ['隥']
膱: ['嬂', '職']
膲: ['臄']
膳: ['膅']
膴: ['嫵']
膹: ['濆']
膻: ['懛', '麕', '臔']
膽: ['脑', '憺', '胍']
膾: ['膌']
膿: ['驤']
臃: ['膆']
臄: ['膲']
臅: ['斶', '觸']
臆: ['膮']
臇: ['臆']
臉: ['脍']
臊: ['膁', '矂']
臍: ['懠', '穧']
臎: ['腰']
臏: ['嬪', '膭']
臑: ['嬬', '燸', '襦', '羺']
臒: ['雘', '餍']
臔: ['膻']
臕: ['皫']
臘: ['臘']
臚: ['曥']
臛: ['嚯']
臝: ['贏', '鸁', '嬴']
臞: ['懼', '爠']
臟: ['贜']
臢: ['膦']
臣: ['兎']
臨: ['臨']
臬: ['韋', '皐']
臭: ['享', '奠']
臯: ['傘']
至: ['奀']
臼: ['旧', '凹']
舁: ['异']
舂: ['春']
與: ['典']
舉: ['擥']
舌: ['亗', '否']
舍: ['含']
舎: ['各', '宫']
舖: ['舗']
舗: ['舖']
舚: ['聸']
舝: ['羣']
舠: ['釖']
舡: ['矼', '釘']
舢: ['鈾']
舦: ['驮', '艋']
舨: ['版']
航: ['蚢']
舫: ['魴', '紡']
舭: ['艉']
舯: ['舺']
舱: ['舩']
舳: ['鮋']
舵: ['詑', '鮀']
舷: ['胘', '鉉']
舸: ['鲄', '鴚', '鈳']
舺: ['舯']
舽: ['胮']
舿: ['绔', '胯']
艀: ['脬', '蜉']
艁: ['鋯']
艄: ['艕', '蛸']
艅: ['錝', '艆']
艆: ['艅']
艇: ['娗']
艈: ['旈']
艋: ['舦']
艍: ['腒', '鋸']
艎: ['媓']
艑: ['媥']
艕: ['鰟']
艘: ['膄']
艙: ['艎', '賶']
艚: ['嶆', '糟']
艛: ['艭']
艜: ['艪']
艟: ['燑']
艠: ['艦']
艡: ['鐳']
艣: ['鐪', '艫']
艦: ['艠']
艧: ['鸌']
艨: ['饛']
艩: ['鑇']
艪: ['艜', '艡']
艫: ['鱸', '艣']
艭: ['艛']
艱: ['難']
色: ['台']
艳: ['毛']
艸: ['蚛']
芀: ['艻']
芃: ['范']
芅: ['子']
芇: ['萡', '干']
芈: ['莩']
芉: ['芊']
芊: ['芓', '苹', '芋', '苸', '莘']
芋: ['芓', '苹', '苸', '莘', '芊']
芎: ['菪']
芐: ['苄']
芑: ['芭', '茾']
芓: ['苹', '芋', '苸', '芊']
芕: ['芵', '芡']
芖: ['茮', '炗']
芗: ['茤', '苓']
芙: ['芵', '芺', '莢', '苿', '芡', '英', '莍']
芛: ['蔀', '萸']
芜: ['炗', '耒']
芡: ['莢', '芙', '芕', '黃']
芣: ['苲', '茉']
芥: ['苀']
芦: ['泸']
芩: ['羋']
芪: ['奃', '茊']
芫: ['茪']
芭: ['芑', '苩']
芰: ['莢', '夌', '苤']
花: ['茌']
芵: ['芙', '芕']
芸: ['芺', '苿']
芹: ['秤']
芺: ['莢', '芙', '苿', '芸']
苂: ['炗']
苃: ['茇']
苄: ['芐']
苌: ['裘']
苍: ['苔']
苓: ['苶', '芗']
苔: ['苍', '苕']
苕: ['苔']
苗: ['莌']
苛: ['荇']
苜: ['苢', '菹', '苴', '莟', '莒']
苝: ['蒞']
苟: ['茍']
苠: ['苣']
苢: ['萏', '莡', '苜', '莟']
苣: ['竟', '苠', '萞']
苤: ['芰']
若: ['苩', '若']
苧: ['芺', '手']
苩: ['芭', '若', '若']
苬: ['齿']
苮: ['茌']
苯: ['革', '荜']
英: ['葰', '芙']
苲: ['芣', '茉', '岝']
苴: ['菹', '苜', '莒']
苶: ['苓']
苷: ['茳']
苸: ['芓', '莩', '苹', '芋', '荚', '荽', '芩', '芊', '菜']
苹: ['芓', '芋', '荚', '萗', '荽', '苸', '芩', '芊', '枽', '坓', '菜']
苼: ['莝']
苿: ['杗', '芺', '芙', '茉', '芸']
范: ['芃']
茅: ['茶', '苿', '茉']
茆: ['窌']
茇: ['苃']
茈: ['庇']
茉: ['茶', '苿', '苲', '茅', '茶']
茊: ['奃', '芪']
茌: ['任', '怔', '花', '仔', '荘', '苮']
茍: ['苟']
茎: ['盋', '茧']
茑: ['箄']
茙: ['荿']
茝: ['繭']
茞: ['坴', '瞾']
茟: ['曅']
茡: ['荦', '李']
茣: ['菒', '棄', '菓', '奠']
茤: ['芗']
茥: ['荃', '蚉', '蛮']
茦: ['萘']
茧: ['蓃', '荾', '萐', '茎']
茩: ['戹']
茪: ['芫', '平']
茬: ['症']
茮: ['荣', '芖']
茰: ['乶']
茱: ['芙', '莱', '莍']
茳: ['荭', '苷']
茶: ['茶', '茉']
茺: ['荠', '蔸', '菀']
茾: ['芑', '垚']
荁: ['螸']
荃: ['基', '莹']
荄: ['葖', '汬']
荅: ['萿']
荇: ['苛']
草: ['稟', '拲', '車', '卓', '皇', '車']
荌: ['婪']
荎: ['莩', '坓']
荑: ['薲', '藀', '薔', '耎']
荒: ['荧']
荓: ['卦']
荘: ['吇', '仼', '荰', '茌']
荚: ['奥', '荽', '坓', '菜']
荛: ['箋', '莾']
荜: ['亊', '孳', '苯', '革', '莘']
荞: ['养']
荟: ['碁']
荠: ['茺']
荣: ['茮']
荦: ['茡']
荧: ['灻', '荒']
荨: ['莮']
荭: ['茳', '荰']
荰: ['任', '荭', '荘']
荱: ['菮']
荳: ['莨']
荸: ['斈', '孪', '季', '李', '菶', '準']
荼: ['栥']
荽: ['荚', '菜', '婱']
荾: ['蓃', '菱', '茧', '菱']
荿: ['茙']
莄: ['蓃', '譱', '菶', '薑', '蘁']
莌: ['苗']
莍: ['芙', '茱']
莎: ['萡']
莒: ['苴', '苜']
莘: ['芋', '荜', '芊']
莚: ['莛']
莛: ['莚']
莝: ['苼', '奎', '蛬']
莞: ['竞']
莟: ['苢', '萏']
莢: ['芰', '芺', '芙', '羙', '芡']
莧: ['萯', '萈', '菎']
莨: ['荳']
莩: ['荎', '苸', '孝', '率', '芈']
莫: ['菒', '菓', '奠']
莬: ['莴']
莮: ['荨']
莯: ['蒾']
莱: ['萊', '茱']
莴: ['莬', '蒚']
莹: ['荃']
莺: ['鹭']
莾: ['荛']
菀: ['蔸']
菃: ['萣', '菪', '菦']
菄: ['葦', '槖']
菅: ['莦', '普']
菆: ['菽']
菋: ['瑓']
菎: ['蒕', '萈']
菐: ['奦', '猆']
菒: ['茣', '棄', '菓', '莫', '葽', '奠']
菓: ['曓', '茣', '菒', '棄', '奠']
菖: ['蒏']
菘: ['萩', '萟']
菙: ['蒫', '董', '蘲']
菜: ['苹', '枼', '荚', '桒', '萰', '楘', '荽', '枽', '葲']
菣: ['哉']
菦: ['菃']
菨: ['婺', '蒆']
菪: ['萣', '菃', '芎']
菫: ['葟']
菮: ['荱']
華: ['羍']
菱: ['蓃', '荾', '菱']
菶: ['蓁', '荸', '譱', '莄']
菹: ['苴', '苜']
菽: ['菆']
萀: ['蒝']
萃: ['皁']
萇: ['葌']
萈: ['蒉', '具', '莧', '菎']
萊: ['蒅', '莱', '汬']
萋: ['蓌', '葁']
萏: ['莟']
萐: ['茧']
萑: ['雈']
萗: ['苹', '枽']
萘: ['茦', '菳']
萛: ['蕒']
萝: ['变', '叟']
萞: ['苣']
萟: ['萩', '菘']
萡: ['莎', '芇']
萣: ['菃', '菪']
营: ['榃']
萧: ['薏']
萩: ['萟', '菘']
萫: ['雚']
萬: ['葻']
萮: ['葤']
萯: ['蔩', '貧', '賁', '莧', '蓄']
萰: ['葲', '菜']
萱: ['藡']
萸: ['芛']
萹: ['萳']
萺: ['瞢']
萻: ['菩']
落: ['落']
萿: ['荅']
葁: ['萋']
葇: ['棻', '楶']
葈: ['薁', '藁']
葉: ['蔂', '葉', '稁']
葊: ['蒼']
葌: ['萇']
葖: ['蒅', '荄', '卖']
著: ['蕾']
葜: ['猆']
葞: ['蘜']
葟: ['蘲', '菫']
葠: ['蓚', '莈']
董: ['蒫', '耋', '蘲', '菙', '輂']
葤: ['蒶', '萮']
葦: ['菄', '棻', '蔁']
葧: ['蓟']
葨: ['葰', '蓑', '蒀']
葩: ['蔸']
葪: ['薊']
葬: ['彜']
葮: ['藙']
葰: ['葨', '英']
葲: ['萰', '菜']
葳: ['繭', '蒇', '葴', '蒧']
葴: ['蒇', '葳']
葸: ['慈']
葹: ['蒟']
葻: ['萬', '萧', '蕭', '薏']
葿: ['蓎', '蘑']
蒀: ['葨', '蒕']
蒁: ['蒾']
蒃: ['菉']
蒅: ['葖', '萊', '某']
蒆: ['婺', '菨', '蒌', '妻']
蒇: ['葴', '葳']
蒉: ['萈', '蔷']
蒌: ['蒫', '蒆', '妻']
蒎: ['蒤']
蒏: ['菖']
蒒: ['薛', '薜']
蒓: ['蔠']
蒕: ['薔', '藠', '盈', '菎', '蒀']
蒖: ['蓘', '彙']
蒘: ['薁', '蕠']
蒚: ['莴']
蒝: ['萀']
蒞: ['苝']
蒟: ['葹']
蒤: ['蒎']
蒦: ['葼', '蔢', '蘴', '薆']
蒧: ['繭', '葳']
蒪: ['薁']
蒫: ['董', '菙']
蒶: ['葤']
蒷: ['暮']
蒸: ['烝']
蒼: ['葊']
蒽: ['蘠', '蘊']
蒾: ['蒁', '莯']
蒿: ['萵', '蓠']
蓁: ['菶']
蓂: ['糵']
蓃: ['荾', '菱', '茧', '莄', '菱', '宴']
蓄: ['蕷', '蔩', '賁', '萯', '蘛', '蔨']
蓅: ['蔋', '蔆']
蓌: ['萋']
蓍: ['蓸']
蓎: ['薝', '蘑']
蓑: ['葨', '羡', '蒀']
蓗: ['蓰']
蓘: ['蔉']
蓚: ['葠', '蔠']
蓛: ['蔌']
蓟: ['葧']
蓠: ['蒿']
蓡: ['蔼', '虃', '薶', '薸', '蓤']
蓤: ['蓡']
蓪: ['蓮']
蓬: ['藡']
蓮: ['蓪', '薳', '薃']
蓰: ['蓗']
蓴: ['蕁', '薰']
蓸: ['蓍']
蓽: ['蔂', '軣']
蔀: ['芛']
蔁: ['葦']
蔂: ['禀', '蓽', '葉', '葉', '稁', '蟇', '軣']
蔆: ['蓅']
蔈: ['蘖', '藥']
蔉: ['蓘']
蔋: ['蓅']
蔌: ['蓛']
蔏: ['蔺', '蔐']
蔐: ['蔺', '蔏']
蔒: ['薫', '鯗']
蔓: ['禀', '戛']
蔘: ['蓼', '繤']
蔙: ['蔟']
蔞: ['萋']
蔟: ['蔙']
蔠: ['蒓']
蔡: ['薒']
蔢: ['蒦', '翣']
蔦: ['薦', '舊']
蔧: ['蒥', '箼']
蔨: ['蓄', '薗']
蔩: ['萯', '蓄', '亴']
蔪: ['薪']
蔭: ['薞', '蕵']
蔳: ['蕅']
蔴: ['蘼']
蔶: ['薲', '燾', '薋', '藀', '藖', '薔', '蒕', '蕢']
蔷: ['蒉', '蕌', '蕃']
蔸: ['葩', '菀', '茺']
蔹: ['蘝', '蘞']
蔺: ['蔐', '蔏']
蔼: ['蓡']
蔾: ['藜', '薒']
蕀: ['橆']
蕁: ['蓴']
蕃: ['蔷']
蕄: ['蕑']
蕆: ['蕨']
蕈: ['虋', '罼']
蕌: ['藇', '藠', '蔷']
蕎: ['繭', '萳']
蕐: ['薴']
蕑: ['藺', '蕄', '藺']
蕒: ['薨', '萛']
蕓: ['曇', '蘌', '藑']
蕖: ['藵']
蕞: ['璽', '蟇', '繤']
蕠: ['蒘', '蘩']
蕡: ['蘦', '薯', '薋', '藖', '葺']
蕢: ['薲', '蕶', '薋', '蔶', '薧', '躉']
蕧: ['藲']
蕭: ['葻']
蕮: ['島']
蕰: ['薀', '薖']
蕵: ['蔭', '薞']
蕷: ['蓄', '蘋']
蕸: ['惹', '蘫']
蕾: ['蘦', '著', '貴', '噩', '朢']
薀: ['蕰']
薁: ['蒪', '蒘', '葈', '藳']
薃: ['蓮']
薆: ['蒦', '虁', '窭']
薊: ['葪']
薋: ['薲', '寷', '蔶', '藖', '薔', '蕢']
薍: ['亂']
薏: ['萧', '葻']
薑: ['莄', '蘁']
薒: ['蔾', '藥', '蔡', '槖', '棻']
薔: ['薲', '薋', '蔶', '蒕', '荑']
薕: ['藦', '蘼']
薖: ['蕰']
薗: ['蔨']
薘: ['蓮', '薻']
薛: ['蒒', '薜']
薜: ['薛']
薝: ['蓎']
薞: ['蔭', '蕵']
薠: ['嵿']
薡: ['鼐']
薥: ['薨']
薦: ['蔦']
薧: ['蕢']
薨: ['蕒']
薪: ['蔪']
薫: ['蔒', '薰', '鯗']
薬: ['棻', '楶']
薮: ['薂']
薯: ['蘦']
薰: ['蓴', '藑', '雧', '薫']
薲: ['薋', '蔶', '薔', '荑', '蕢']
薳: ['蓮']
薴: ['孶']
薶: ['蓡']
薷: ['蘭', '責']
薹: ['蘲']
薻: ['蓮', '薘']
薼: ['蘮']
薾: ['蘭']
藁: ['蕓', '葈', '藄', '璽', '藳']
藄: ['蘻', '蘩', '藁']
藇: ['蕌']
藋: ['雚', '壨']
藌: ['壐', '蘌']
藎: ['譱', '鲝']
藑: ['蕓', '薰', '夐']
藓: ['蘚']
藖: ['鼜', '薋', '蔶', '蕡']
藙: ['葮']
藜: ['蔾']
藝: ['孶', '稾']
藟: ['螶', '蠶']
藠: ['蕌', '雚', '蒕', '嚞']
藡: ['蓬']
藣: ['蘱']
藤: ['虅']
藥: ['蘃', '蔈', '蘖', '橐', '薒']
藦: ['薕', '蘼']
藫: ['顰']
藬: ['蘟']
藲: ['蕧']
藳: ['羹', '櫜', '璽', '薁', '褭', '藁', '繤']
藵: ['蕖']
藺: ['藺', '蕑']
蘁: ['譱', '薑', '莄']
蘂: ['糵']
蘃: ['橐', '藥', '蕖']
蘆: ['蘆', '蘪', '蕾', '噩']
蘊: ['蒽', '蘠']
蘋: ['蕷']
蘌: ['藌']
蘑: ['葿', '蓎']
蘖: ['蔈', '糵', '藥', '蘗']
蘗: ['蘖', '虊', '糵']
蘘: ['嚢']
蘚: ['藓']
蘛: ['蓄']
蘜: ['葞']
蘝: ['蔹', '蘞']
蘞: ['蘝', '蔹']
蘟: ['藬']
蘠: ['蒽', '蘊']
蘡: ['孁']
蘦: ['薯', '蕾']
蘩: ['藄', '蕠']
蘪: ['蘆', '蘆']
蘫: ['蕸']
蘭: ['薾', '蘭']
蘮: ['薼', '瞢', '蘭']
蘱: ['藣']
蘲: ['董', '葟', '菙', '錃', '薹']
蘴: ['蒦']
蘻: ['藄']
蘼: ['蔴', '薕', '藦']
蘽: ['橐']
蘿: ['蘿']
虀: ['韲']
虁: ['蘡', '薆']
虂: ['蕾']
虃: ['蓡']
虅: ['藤', '繭']
虊: ['蘗']
虋: ['謩', '蕈']
虐: ['雐', '虘']
虔: ['虙', '虖']
虖: ['虙', '虔']
虗: ['垕']
虘: ['雐', '虐']
虙: ['虖', '虔']
虚: ['虛']
虛: ['虚']
虜: ['虜']
虞: ['廩', '虡']
虠: ['錿']
虡: ['虞']
虫: ['午']
虭: ['蚎']
虮: ['処']
虰: ['釘', '訂']
虳: ['抣', '约', '妁', '訋', '均']
虴: ['灹', '託', '衃']
虵: ['蚔', '蚍']
虶: ['轩', '訏', '訐', '扜']
虷: ['轩', '紆', '竏']
虸: ['虾']
虼: ['蛇', '纥']
虽: ['县', '里', '显', '里', '圼']
虾: ['虸']
蚄: ['鈁']
蚅: ['鈪', '蜽']
蚆: ['鈀', '妑', '蚷', '皅']
蚇: ['鈬']
蚈: ['姸', '岍', '竔', '妍', '蚢', '咞']
蚉: ['斈', '茥', '蛮']
蚊: ['蚞']
蚋: ['蚰']
蚍: ['虵', '蚔', '崐']
蚎: ['鈤', '虭']
蚑: ['岐', '蚨', '峖', '蚿', '蛱']
蚔: ['軧', '虵', '蚍']
蚕: ['垂']
蚖: ['蚢']
蚗: ['蛉', '佚']
蚘: ['蚝']
蚙: ['蛤']
蚚: ['斩', '釿', '炘']
蚛: ['艸', '鉒']
蚜: ['呀', '岈']
蚝: ['竓', '蚘']
蚞: ['蛃', '蚊', '蚌']
蚡: ['躮', '蚧']
蚢: ['航', '蚈', '蛙', '秔', '岤']
蚦: ['爼']
蚧: ['蚯', '蚡', '蛴', '蛇']
蚨: ['蚑', '蚿']
蚬: ['蛌']
蚯: ['蚧']
蚰: ['蚋', '蚴', '蜬', '紬', '铀']
蚴: ['蚰']
蚵: ['袔', '蚷', '跒']
蚶: ['蛆']
蚷: ['蚵', '蚆', '鉅']
蚸: ['蚔']
蚺: ['螻', '蠙']
蚻: ['蜇']
蚼: ['絢']
蚿: ['魼', '蚑', '蚨']
蛀: ['炷']
蛁: ['貂', '鉊']
蛃: ['蚞', '蜏']
蛄: ['钴']
蛅: ['鈷', '鉆']
蛆: ['蚶']
蛇: ['虼']
蛉: ['蚗']
蛊: ['盗']
蛌: ['岘', '蚬']
蛎: ['蜛']
蛏: ['蛭']
蛑: ['蝇']
蛓: ['裁']
蛔: ['蝞', '蟈', '蛧']
蛖: ['螠']
蛗: ['蠆']
蛙: ['烓', '蚢']
蛚: ['蝄']
蛛: ['錸']
蛟: ['蛺']
蛡: ['翊']
蛢: ['饼']
蛣: ['蛿']
蛤: ['蚙']
蛥: ['恀', '蝆']
蛦: ['蟽', '峓', '蠙']
蛧: ['蝞', '蛹', '蛔']
蛨: ['姡', '竡', '岹', '蛄', '銆']
蛩: ['銎']
蛫: ['陒', '蝜']
蛬: ['荎', '莝']
蛭: ['臸', '蛏']
蛮: ['蚉', '茥', '孪']
蛰: ['蟄']
蛱: ['蚑', '峡']
蛲: ['蝧']
蛴: ['蚧']
蛵: ['烴']
蛶: ['锊']
蛷: ['蚑', '帓', '觩', '蚿']
蛸: ['銷', '艄']
蛹: ['蝄']
蛺: ['岟', '崍', '蛟']
蛼: ['崎', '峍', '蠙']
蛽: ['螟']
蛿: ['蛣']
蜃: ['愿', '厪', '凰', '歷', '歷', '廤']
蜅: ['峭', '蝤']
蜆: ['蜕']
蜇: ['蚻']
蜈: ['娛']
蜉: ['姅', '艀']
蜊: ['鋓']
蜌: ['螳']
蜍: ['嵘', '悇']
蜐: ['蟘']
蜓: ['梃']
蜕: ['鋭', '絣', '蜆', '脱']
蜛: ['鋸', '蛎']
蜞: ['棋']
蜟: ['蠐']
蜡: ['绪']
蜦: ['崘', '鯩']
蜨: ['嵣', '崨', '蜯']
蜩: ['蜠', '鲷']
蜪: ['祹']
蜫: ['蝇']
蜬: ['蚰']
蜮: ['蝼']
蜯: ['蜨', '蟑', '崨']
蜱: ['蝆']
蜲: ['蝬', '矮', '峻', '蝼']
蜳: ['椁', '犉', '嵉']
蜵: ['婣']
蜶: ['稡']
蜷: ['裷']
蜸: ['塱']
蜻: ['蟫', '皘', '崝']
蜽: ['蚅']
蜾: ['輠']
蜿: ['蝷']
蝀: ['螕']
蝁: ['聖']
蝂: ['蟩', '蠍']
蝃: ['畷', '蟩']
蝄: ['蝐', '蛚', '蛹', '蝸']
蝆: ['蜱', '蛥']
蝇: ['绳', '蛑', '蜫']
蝈: ['掴']
蝉: ['婵']
蝍: ['蝴', '卿']
蝎: ['餲', '蝠', '竭']
蝏: ['蟯']
蝐: ['蝄']
蝑: ['蟦', '糈']
蝓: ['崳']
蝕: ['餭']
蝖: ['愃', '犆']
蝗: ['螕', '隍']
蝜: ['蛫']
蝝: ['餯', '蟓', '蟏']
蝞: ['蛔', '蛧', '蝸']
蝠: ['褔']
蝢: ['領', '頜', '螅']
蝤: ['蜅']
蝥: ['堥', '奎']
蝧: ['蛲']
蝨: ['螽', '蟸', '蟲']
蝫: ['禇', '螃', '绪']
蝬: ['蟥', '蝛', '蜲']
蝮: ['鳆']
蝯: ['嫒']
蝳: ['蜻', '襀', '崝', '嵴']
蝴: ['蝍']
蝵: ['蟄']
蝶: ['蟝', '蠑']
蝷: ['蜿', '螰']
蝸: ['蝞', '蝄']
蝹: ['鞰', '螁', '螞']
蝻: ['螪']
蝼: ['蜲', '峻']
蝿: ['蠉']
螁: ['腿']
螃: ['蝫', '鳑', '嵭', '螝']
螅: ['蝢']
螊: ['蟂']
螌: ['螜']
螐: ['崅']
螑: ['螾']
螔: ['蟾']
螕: ['蝗', '蝀']
螗: ['蟮', '螦', '螑', '崉', '螰']
螙: ['螡']
螜: ['螌', '螿']
螞: ['蝹']
螟: ['蛽']
螠: ['蛖', '螆']
螡: ['螙']
螣: ['媵', '胿', '脪']
螤: ['斔']
螦: ['蟮', '螗', '螑', '蟟']
螧: ['鳍', '蠐', '愭']
螪: ['蟑', '蝷']
螫: ['蟼', '鰲', '整']
螬: ['慒', '褿', '鏪']
螭: ['螮', '褵']
螮: ['嵽', '螭']
螰: ['蝷']
螳: ['蜌']
螴: ['蟹', '蟞']
螵: ['熛', '蠌']
螶: ['蠠']
螷: ['匮', '廛', '麈']
螸: ['荁', '螫']
螹: ['蟖']
螺: ['缧', '螺', '嫘']
螻: ['蠙']
螽: ['蝨', '蟲']
螾: ['螑']
蟀: ['崥', '繂']
蟁: ['螶']
蟂: ['蝃', '蟍', '螊']
蟄: ['蝵', '蛰']
蟇: ['蔂', '蕞', '繤']
蟈: ['蛔']
蟋: ['蠎']
蟍: ['蟝', '蟂']
蟏: ['蟓', '蟔', '蠟']
蟑: ['犝', '螪', '蜯', '蝷']
蟒: ['蠎']
蟓: ['蟏', '蟔', '蝝']
蟔: ['蟓', '蟏']
蟕: ['蟷', '蠇']
蟖: ['螹']
蟘: ['蜐']
蟙: ['嬂']
蟚: ['蠒']
蟜: ['蟠']
蟝: ['蠑', '蝶', '蟍']
蟞: ['螴']
蟟: ['蟬']
蟠: ['蟜']
蟡: ['蟾', '嵨']
蟢: ['嬉', '憘', '蟡', '蟪', '蠦', '暿']
蟣: ['蟘']
蟥: ['蝬']
蟦: ['蝑', '轒']
蟧: ['軂']
蟩: ['鳜']
蟪: ['蟢']
蟫: ['蜻', '鐔']
蟬: ['餫', '蟟']
蟭: ['蟂', '嶕']
蟮: ['嶟', '螗']
蟯: ['嶢', '蝏']
蟰: ['嶿']
蟲: ['蝨', '螽']
蟷: ['蟕', '蟐', '蠕']
蟸: ['蝨']
蟼: ['螫']
蟽: ['蛦']
蟾: ['螔']
蟿: ['蠪', '壨']
蠀: ['蠖']
蠁: ['蠪']
蠂: ['蟍']
蠃: ['赢', '贏', '鸁', '嬴', '驘', '羸']
蠆: ['璽', '墨']
蠇: ['蟕', '贎']
蠉: ['蠗', '蝿']
蠋: ['镯']
蠌: ['螵', '襗']
蠍: ['蝂']
蠎: ['蟒', '蟋']
蠐: ['螧', '蜟', '櫅', '艩']
蠑: ['蟝', '蝶']
蠒: ['量', '蟚', '量']
蠕: ['糯', '蟷', '隭']
蠖: ['韄', '蠀']
蠗: ['蠉']
蠙: ['螋', '蛦', '蛼', '蚺', '螻']
蠜: ['攀']
蠝: ['礧', '鑘']
蠟: ['鱲', '蟏', '蝋']
蠠: ['螶', '噩']
蠡: ['蠭']
蠥: ['孼']
蠦: ['蟪', '蟢']
蠪: ['襲', '壨', '蠁']
蠬: ['朧', '贚']
蠭: ['蠡']
蠯: ['廩', '廪', '鏖', '鷢', '鷹', '麇']
蠳: ['蠼', '蠷']
蠶: ['螶', '藟']
蠷: ['蠳', '躣', '嬥']
蠸: ['蟻', '權']
蠻: ['髺', '螚', '孿']
蠼: ['蠳']
衃: ['虴']
衋: ['靊', '盙']
行: ['行']
衎: ['裄', '垳']
衙: ['衛']
衛: ['衙']
衝: ['衡']
衟: ['衠']
衠: ['衟']
衡: ['衝']
衤: ['牜']
补: ['祁', '礼']
衧: ['粁', '杄', '杆']
衪: ['祂']
衫: ['衿']
衬: ['討']
衭: ['袂', '祱', '祛']
衮: ['裵', '袬']
衯: ['竕', '訜', '秎']
衰: ['袞', '袬', '褏']
衳: ['松', '裞']
衴: ['扶', '衿']
衶: ['袖', '蚰', '祌', '铀']
衷: ['裒', '亵']
衸: ['妎', '吤', '峅', '祄', '粇', '袕']
衹: ['袛', '祇']
衺: ['裛', '褢']
衻: ['枏']
衼: ['袟', '披', '袨', '袜']
衽: ['抂', '祅', '扛', '秄', '岾', '祗']
衾: ['裘']
衿: ['袏', '衴']
袀: ['礿']
袁: ['裘', '裵']
袂: ['呋', '衭', '祛']
袄: ['祆', '扷', '杕']
袅: ['桒', '奥', '袰']
袆: ['讳', '祎']
袈: ['装']
袊: ['吟']
袌: ['襃']
袍: ['杝']
袏: ['咗', '衿']
袐: ['秘', '祕']
袓: ['詛']
袔: ['蚵']
袕: ['拕', '祄', '忼', '粇', '衸', '拉']
袖: ['衶', '枘', '祌']
袗: ['袨', '診']
袘: ['柂']
袙: ['絈']
袛: ['衹', '秪', '裩', '祇']
袜: ['皌', '袨', '衼']
袞: ['衰', '袬']
袟: ['衼', '株']
袡: ['褐', '抩']
袥: ['拓', '裕', '拓']
袧: ['枸', '訽', '构']
袨: ['衼', '袗', '禌', '袜']
袩: ['帖', '枯']
袪: ['裌']
被: ['詖', '跛', '狓', '坡']
袬: ['窠', '袞', '茛', '衰', '衮']
袭: ['裴']
袮: ['袘', '祢', '称']
袯: ['祓']
袰: ['袅']
袱: ['枞']
袲: ['褒', '褭']
袴: ['裺', '徬']
袵: ['栣']
袶: ['洚', '裤']
袷: ['粭', '祫', '姶', '祜', '帢']
袸: ['裌']
袹: ['栢']
袺: ['桔']
袻: ['裲', '祵']
袼: ['祂']
袾: ['襙', '殊']
裀: ['秵', '裍', '駰']
裂: ['製', '裂']
裄: ['垳', '衎']
装: ['袈']
裆: ['秚']
裇: ['殈', '桖']
裈: ['挥']
裉: ['银', '拫']
裊: ['裛', '裠']
裌: ['袪', '铗', '祑', '袸', '棶']
裍: ['裀', '裲', '梱', '稇', '稛', '祵']
裎: ['禋', '桯']
裏: ['裏', '裹', '褢', '裠']
裐: ['柌', '梋']
裑: ['銵']
裒: ['亵']
裓: ['祴']
裕: ['綌']
裖: ['祳', '振']
裗: ['撩']
裘: ['袁', '衾']
裚: ['裟']
裛: ['裹', '衺', '褢', '槀']
補: ['秿']
裞: ['衳']
裟: ['娑', '裚']
裠: ['裹']
裡: ['娌', '裡']
裢: ['链']
裣: ['猃']
裤: ['袶']
裥: ['裯', '掆', '禍', '禂', '襇']
裦: ['褭', '褱']
裧: ['啖']
裨: ['挬', '椑']
裩: ['掍', '褪']
裫: ['襴', '棩']
裬: ['祾', '绫']
裮: ['椙', '祻']
裯: ['裥', '禍', '绸', '稠', '禂']
裰: ['襁']
裱: ['婊', '脿']
裲: ['裍', '袻', '祵']
裴: ['袭']
裵: ['袁', '衮']
裶: ['棑', '猅', '婔']
裷: ['蜷', '犈']
裸: ['祼', '祿']
裹: ['襄', '裏', '裛', '裏', '褱', '繤', '褢', '裠']
裺: ['袴']
製: ['裂', '裂']
裾: ['锯']
裿: ['婍', '褃', '掎', '祷']
褀: ['祺']
褃: ['襎', '襠', '楨', '裿']
褄: ['榡']
褅: ['揥', '棉', '禘']
褆: ['禔', '禄']
複: ['稪']
褉: ['碶', '禊']
褊: ['编']
褋: ['禖']
褌: ['襅', '禅', '禈']
褍: ['椯', '煓']
褎: ['袠']
褏: ['衰']
褐: ['袡', '褔', '羯']
褑: ['褸', '禐']
褒: ['袲', '褭', '褱']
褔: ['蝠', '稫', '福']
褖: ['禒', '掾']
褗: ['揠', '摳', '擢']
褘: ['椲', '禕']
褙: ['禙']
褚: ['媎', '楮']
褜: ['瞏']
褝: ['掸']
褞: ['嗢', '褴']
褟: ['搨', '禤', '塌', '禢']
褠: ['媾']
褡: ['挌', '掿']
褢: ['裏', '裛', '裹', '裏']
褤: ['撓', '媴']
褨: ['搓']
褪: ['裩', '蹆']
褬: ['嗓']
褭: ['袲', '裦', '褒', '褱', '藳']
褱: ['襄', '裦', '褒', '褭']
褴: ['褞']
褵: ['槗', '螭']
褶: ['裐']
褸: ['褑', '縷']
褺: ['裂', '蟄']
褼: ['褸']
褾: ['嫖']
褿: ['螬', '慒', '榰']
襀: ['掅', '皘', '嫧', '撌']
襁: ['裰']
襂: ['椮', '穇']
襃: ['袌']
襄: ['裹', '褭', '褱']
襅: ['褌', '禈']
襇: ['裥', '掆', '襉']
襉: ['掆', '襇']
襌: ['禪']
襍: ['磼']
襎: ['嬏', '燔', '褃', '襠', '嶓', '橎']
襏: ['撥']
襐: ['鐌', '掾', '豫', '褖']
襑: ['燖']
襒: ['撇', '黴']
襓: ['禞', '镜', '摬']
襗: ['檡']
襘: ['禬']
襙: ['鎟', '搡', '袾', '褋', '噪', '操']
襚: ['禭']
襜: ['襣']
襝: ['撿']
襠: ['襎', '褃', '檑', '檔']
襡: ['濁']
襢: ['檀']
襣: ['擤', '襜']
襤: ['壏']
襦: ['臑', '壖', '嬬', '摴', '燸', '羺']
襧: ['穪']
襨: ['嚉']
襩: ['禲']
襭: ['撷']
襮: ['摄']
襰: ['獺']
襱: ['攏']
襲: ['蠪']
襳: ['殱']
襴: ['裫']
襸: ['囋', '禶']
襹: ['穲']
襼: ['囈']
襽: ['灡']
襾: ['帀', '两']
覀: ['耂']
覉: ['覇']
見: ['見']
規: ['絸']
視: ['视']
覚: ['悹']
覛: ['覿', '覻']
覢: ['顃']
覯: ['靚']
覰: ['覻']
覷: ['觑']
覺: ['覽']
覻: ['覿', '覛', '覰']
覽: ['覺']
覿: ['觀', '覛', '覻']
觀: ['顴', '覿']
见: ['仉']
视: ['視']
觉: ['党']
觑: ['覷']
觖: ['缺']
觘: ['魦']
觙: ['魥']
觟: ['鲑', '鮭']
觤: ['鮠']
觧: ['解']
觨: ['魷']
觩: ['蛷', '鯄']
觪: ['鲜']
觬: ['鯢']
觵: ['鱑']
觸: ['斶', '觽', '臅']
觺: ['鶭']
觻: ['鏿', '鑅', '纅', '鱳']
觽: ['觸']
訁: ['冫']
訂: ['虰', '灯']
訇: ['匍', '匎', '匐']
計: ['针']
訊: ['詛']
訋: ['虳']
訌: ['飪']
訍: ['詼']
討: ['衬', '纣']
訏: ['吁', '轩', '訐', '虶', '圩']
訐: ['吁', '轩', '訏', '紆', '虶', '奷', '竏']
訑: ['訹', '診', '詅']
訒: ['纫']
訓: ['詞']
訖: ['詑', '訦']
託: ['吒', '灹', '虴']
記: ['紀', '詀']
訙: ['訣']
訚: ['阊', '圃', '阖', '阃']
訛: ['詂']
訜: ['衯', '訞', '竕']
訞: ['岆', '訜']
訟: ['詓', '誽']
訡: ['耹']
訢: ['听', '釿', '岓', '紤']
訣: ['謁', '詨', '訙']
訤: ['說', '訿', '説', '訬']
訦: ['詁', '衴', '訖']
訧: ['紌']
訨: ['祉', '話']
訬: ['訹', '詮', '訤']
設: ['訯', '詜']
訮: ['詽', '証']
訯: ['設', '諟']
訰: ['誥', '詴', '詿', '詫']
許: ['評', '詐']
訵: ['誷']
訸: ['訬']
訹: ['訑', '諑', '訬']
診: ['誌', '詨', '誃', '袗', '訑', '諑', '詅']
証: ['訮', '詽', '詁']
訾: ['曾']
訿: ['誠', '誂', '訑', '説', '訤']
詀: ['钻', '記']
詁: ['秙', '轱', '姑', '証']
詂: ['諿', '訛', '謌']
詃: ['諛', '該', '詓', '詇']
詄: ['跌', '詜']
詅: ['誃', '訑', '診']
詇: ['詵', '誛', '諛', '該', '詓', '詃']
詉: ['諔']
詊: ['誶', '詫']
詍: ['謏', '謥', '詪', '譞', '詜']
詐: ['許']
詑: ['舵', '訖']
詒: ['詥', '詻', '誝', '誥']
詓: ['諛', '該', '詇', '詃']
評: ['許']
詖: ['諕', '被', '謏', '誺', '該', '譞', '耚', '跛', '坡']
詗: ['詷', '詡']
詘: ['誯']
詙: ['詪', '詖']
詚: ['詛']
詛: ['訊', '詚', '誀']
詜: ['謖', '謏', '設', '詄', '詍', '誄']
詞: ['訓']
詠: ['詸']
詡: ['詗', '翓']
詣: ['詰']
詤: ['談', '課', '譫']
詥: ['詒', '詻', '誝']
詨: ['跤']
詩: ['諤', '誇']
詪: ['誆', '謏', '誫', '詙']
詫: ['詊', '訰']
詮: ['訑', '謡', '訬']
詰: ['詣']
話: ['訨']
該: ['誛', '誺', '詓', '詖', '詇', '詃']
詴: ['訰']
詵: ['詖', '詇']
詶: ['調', '誗', '謿']
詷: ['詗', '調']
詸: ['詠', '諌', '諫', '誎', '諼', '咪']
詼: ['訍', '誃']
詽: ['訮', '証']
詿: ['誙', '誈', '訰']
誀: ['詛']
誂: ['說', '訿']
誃: ['詼', '診', '詅']
誄: ['諞', '謥', '誺', '諘', '諍', '詜']
誅: ['諜', '譟', '譙']
誆: ['詪']
誇: ['諄', '誟', '詩']
誈: ['詿', '誙']
誉: ['嚳']
誌: ['診']
認: ['謌']
誎: ['諌', '諫', '誴', '謉', '詸', '誏', '謶']
誏: ['談', '誎', '埌', '哴', '謶', '譲']
誐: ['說']
誒: ['謐', '諜']
誖: ['誟']
誗: ['詶']
誘: ['誢']
誙: ['詿', '誣', '誈']
誚: ['誯']
誛: ['諹', '骎', '該', '詇']
誜: ['謨', '諉']
誝: ['詒']
誟: ['諄', '誖', '誇']
誠: ['誡', '訿']
誡: ['諴']
誢: ['誘']
誣: ['誙']
誤: ['諼']
誥: ['誻', '訰']
誦: ['誷']
誧: ['諵', '譳']
說: ['誐', '誂', '說', '說', '説', '訤']
誫: ['諰', '詪']
説: ['說', '訿', '訤']
読: ['諭']
誰: ['譨', '諜']
誱: ['謏', '謥', '諻']
課: ['詤', '謀']
誴: ['諫', '諒', '謉', '諚', '誎', '詜', '骔']
誵: ['諿', '諸', '謌', '諳']
誶: ['詊']
誷: ['訵', '誦']
誺: ['諒', '該', '詖', '謼', '誄']
誻: ['謗', '諸', '諳', '誥']
誼: ['諒', '諠']
誽: ['諞', '訟']
誾: ['閛', '闡', '閸', '閕', '閤', '焛', '閞', '閹', '閱', '鬧', '閩', '闇']
調: ['詷', '詶']
諁: ['謤', '謳']
諄: ['誟', '誇']
諆: ['猉', '踑']
談: ['詤', '誏']
諈: ['諻']
諉: ['誜', '諩']
請: ['譚', '譆']
諌: ['諫', '謉', '誎', '詸', '謶']
諍: ['誄']
諎: ['誵', '諧']
諏: ['譀']
諐: ['鬙']
諑: ['訹', '診']
諒: ['諦', '誼', '諛']
諔: ['詉']
諕: ['謯', '詖']
論: ['譸']
諗: ['詖']
諘: ['諒', '誄']
諙: ['譖']
諚: ['誴', '聢']
諛: ['諒', '詓', '詇', '詃']
諜: ['譨', '誒', '謋', '誅', '譟', '誰']
諝: ['諿', '謌']
諞: ['誽', '誄']
諟: ['訯']
諠: ['誼', '譇']
諢: ['譂']
諤: ['詩']
諥: ['謱', '諼', '譫', '讍']
諦: ['諒']
諨: ['謁']
諩: ['誆', '謢', '諉', '謚']
諫: ['諌', '諒', '誴', '謉', '謥', '誎', '詸', '謊', '誄']
諬: ['譼', '諅']
諭: ['謪', '譎', '読']
諯: ['譾']
諰: ['誫']
諱: ['謢', '鎳', '謾', '譿']
諳: ['誵', '誻', '諸']
諴: ['誡']
諵: ['謪', '誧', '謞']
諶: ['謀', '譲']
諸: ['誵', '詴', '誻', '諳']
諹: ['譪', '誛']
諻: ['諈', '謏', '謥', '誱']
諼: ['謱', '諥', '詸', '誤']
諾: ['諾']
諿: ['誵', '諝', '詂', '謌']
謀: ['課', '諶']
謁: ['訣', '諨']
謄: ['膤', '膡', '膻', '膦']
謆: ['謫']
謇: ['讆']
謈: ['髻', '疂']
謉: ['諌', '諫', '誴', '誎', '謊', '謶']
謊: ['諫', '誴', '謉', '謠']
謋: ['諜']
謌: ['誵', '諿', '諝', '詂', '認']
謎: ['譢', '讁', '譴']
謏: ['讃', '謥', '諻', '詖', '詍', '詜', '誱']
謐: ['誒', '謔']
謑: ['護']
謓: ['謴']
謔: ['謐', '譃', '譫', '譙']
謕: ['讂', '譠', '譞', '讔', '讍']
謖: ['譔', '謾', '詜']
謗: ['誻']
謙: ['誅', '譟']
謚: ['謥', '諉', '諩']
講: ['讃', '譩']
謝: ['塮']
謞: ['謪', '諵', '鶢']
謠: ['謊']
謡: ['詮']
謢: ['謱', '讂', '諚', '諱', '鏶', '諩']
謣: ['諢', '譆', '譂']
謤: ['謯', '諁', '譿', '讀']
謥: ['諫', '謏', '譓', '諻', '詍', '誱', '誄']
謦: ['聾', '讆']
謨: ['誜']
謪: ['諭', '諵', '謞']
謫: ['謆']
謬: ['詉']
謭: ['譗', '譵']
謮: ['謯', '讀', '譓', '詖', '讀', '讚', '譴', '謼', '譞']
謯: ['謤', '諕', '譿', '謮', '讀', '讉', '謼', '讍']
謱: ['讂', '謢', '諥', '誤', '諼', '諟']
謲: ['讃', '謕', '譈', '讚']
謳: ['諁']
謶: ['諌', '謉', '諚', '誎', '誏']
謸: ['譤']
謹: ['議', '讒', '讙', '讌']
謼: ['謯', '誺', '謮']
謾: ['謖', '諱']
謿: ['詶']
譀: ['諏', '譤']
譂: ['諢']
譃: ['謱', '譨', '讈', '謔']
譅: ['譿', '譠', '謳', '讝', '讔', '讍']
譆: ['請']
譇: ['諽', '諠']
譋: ['讇']
譌: ['諽']
譍: ['麐', '鹰']
譎: ['譝', '諭']
譐: ['誶', '譜']
譑: ['譓']
譒: ['譡']
譓: ['謥', '譠', '譞', '譑', '讍']
譔: ['謖']
譖: ['諙']
譗: ['謭']
識: ['讉']
譙: ['誅', '謔']
譚: ['請', '謬']
譛: ['譜']
譜: ['謒', '譐', '譛']
譝: ['譎']
譞: ['譓', '詖', '詍']
譟: ['諜', '誅', '謙']
譠: ['誆', '謕', '譓', '譅', '讀', '譑', '讍']
譡: ['譪', '譒', '諠']
譢: ['謎', '譴']
譤: ['譀', '謸']
譥: ['警', '嫳', '讋', '聾']
警: ['譥']
譨: ['諜', '譃', '誰', '譲', '譫']
譪: ['譡', '諹', '譾']
譫: ['譨', '詤', '諜', '謔']
議: ['謹']
譱: ['羕', '義', '菶', '莄', '藎', '蘁']
譲: ['誏', '諶']
譳: ['誧']
譴: ['譢', '謎', '謮', '讉']
譵: ['謭']
譶: ['褭']
護: ['謑']
譸: ['論', '譃', '讈']
譼: ['諬']
譽: ['鸒']
譾: ['諯', '譪', '讘']
譿: ['謤', '謯', '讂', '諱', '譅', '讀']
讀: ['諲']
讂: ['謱', '謢', '謕', '讈', '譿']
讃: ['謏', '讚']
讅: ['譁']
讆: ['謇', '聾', '謦']
讇: ['譋']
讈: ['讂', '讝']
讉: ['謯', '識', '譴', '謳']
讋: ['譥']
讌: ['讜', '讒']
讍: ['謖', '謱', '謯', '讂', '謕', '諥', '譓', '譅', '讀', '譠', '讝']
讒: ['謹', '讜', '議', '讙', '讌']
讔: ['謕', '譅', '讝']
讘: ['譾']
讙: ['謹', '議', '讒']
讚: ['讃', '譒', '謮', '讀', '譞']
讜: ['讒', '讌']
讝: ['讈', '譅', '讔', '讍']
讠: ['十', '犭', '个', '丨']
订: ['讨', '灴']
讣: ['汁', '卜']
认: ['丷', '讧', '让', '饫', '汄']
讥: ['见', '仇', '丗', '讼']
讦: ['仠', '钚', '奸', '纡']
讧: ['仕', '让', '仜', '佂', '玒', '认', '证']
讨: ['订', '时']
让: ['丷', '仕', '讧', '仜', '诂', '玒', '认']
讪: ['炪', '诎']
讫: ['阣']
讬: ['牦']
训: ['饳', '汌', '讷']
议: ['洨']
讯: ['迅', '汛', '沑']
记: ['论', '玘']
讲: ['汫']
讳: ['袆']
讴: ['沤', '评']
讵: ['诅', '仾', '怇']
讷: ['训']
许: ['卋', '汼']
讹: ['批']
论: ['怆', '记', '佗', '价']
讼: ['讥']
访: ['防', '紡', '忼']
证: ['讧', '仜', '佂']
诂: ['让', '迏']
诃: ['河']
评: ['讴', '呯', '垀', '坪']
诅: ['讵', '仾', '怇']
识: ['伿']
诇: ['惘', '恫']
诉: ['诋', '泝']
诋: ['低', '诉', '忯']
词: ['伺', '饲']
诎: ['灿', '汕']
诏: ['铝']
诒: ['治']
诓: ['洭']
诔: ['铼', '谅', '拺', '谏']
诘: ['洁', '姞', '拮']
话: ['迀', '辷']
诠: ['迀', '汢', '话']
询: ['恂', '姁']
诣: ['恉']
诤: ['挣', '錚']
该: ['谈']
详: ['徉', '佯']
诨: ['浑']
诩: ['焩']
诪: ['陦']
语: ['侰', '焐', '倨', '涒']
诮: ['消', '俏']
诰: ['锆']
诶: ['谈', '淚', '挨']
请: ['锖', '情', '焴']
诸: ['渚']
诽: ['陫']
课: ['淉']
谁: ['稚', '维', '推']
谂: ['淰']
调: ['淍']
谄: ['惂']
谅: ['诔']
谆: ['淳']
谇: ['伡']
谈: ['锬', '诶', '该']
谉: ['淳']
谌: ['揕']
谍: ['媟', '牃']
谏: ['诔', '揀', '拺', '捒', '淭']
谐: ['谙']
谒: ['愒']
谓: ['稩']
谔: ['肙']
谖: ['锾', '谡']
谙: ['谐']
谛: ['渧']
谝: ['褊', '揙']
谡: ['谖']
谥: ['隘', '溢', '逵']
谦: ['搛', '槏']
谨: ['湰', '獞', '嫤']
谩: ['馒']
谭: ['镡', '潭', '墰', '曋']
谰: ['澜']
谵: ['澹']
谶: ['瀸']
谹: ['欲']
谻: ['谼']
谼: ['谻']
豂: ['缪', '蹘', '镠']
豃: ['橄']
豅: ['壠', '躘']
豆: ['页']
豇: ['肛']
豈: ['豈']
豉: ['馶']
豊: ['壼', '亶']
豍: ['聛']
豎: ['疍']
豞: ['胊']
豠: ['租', '駔', '砠']
豣: ['趼', '钘', '鈃']
豤: ['跟', '貇']
豧: ['鬴']
豪: ['稁']
豫: ['襐']
豰: ['縠', '毂', '穀']
豲: ['騵']
豶: ['鐼']
豸: ['糹']
豻: ['钎', '秆', '屽', '扜']
豼: ['纰']
豽: ['貀']
貀: ['豽']
貂: ['貃', '鉊', '蛁', '韶']
貃: ['貂']
貇: ['跟', '豤']
貉: ['辂']
貐: ['騟']
貑: ['騢']
貕: ['貘', '騱']
貗: ['髏']
貘: ['貕']
貙: ['鏂']
貚: ['軃']
貟: ['貣', '貫']
財: ['肘']
貢: ['貨']
貣: ['貟', '賁', '貫']
貥: ['阬', '骯']
貧: ['萯']
貨: ['貢']
販: ['貾']
貪: ['寘', '賃']
貫: ['貣', '貟']
責: ['薷', '掱', '貰', '疐', '貴', '霊']
貭: ['僋']
貰: ['賫', '賚', '責']
貲: ['買']
貳: ['贰']
貴: ['蕾', '責']
買: ['贵', '貲']
貸: ['資', '賀', '員']
貹: ['胜']
費: ['赛', '翬']
貼: ['贴', '阽']
貽: ['胎']
貾: ['販', '胝', '賊']
貿: ['寊']
賀: ['貸', '資', '貨', '賈', '賈', '貢', '員']
賁: ['貣', '萯', '蓄']
賂: ['賂', '胳']
賃: ['贯', '賈', '賈', '簧']
賄: ['賭', '賎']
賅: ['赅', '胲', '賊']
資: ['貸', '賀', '賈', '賈', '員']
賈: ['資', '賌', '嚚', '賈', '寘', '賃']
賊: ['賋', '賍']
賋: ['赅', '鉸', '賊']
賌: ['賈', '賈']
賍: ['赃', '賊']
賎: ['賄']
賐: ['脧', '朘']
賑: ['陙', '赈']
賕: ['脙']
賖: ['賩']
賚: ['賫', '貰', '賷']
賛: ['嘼']
賞: ['賲']
賠: ['賰']
賡: ['唐']
賢: ['驚']
賣: ['夁', '鹭']
賦: ['陚', '赋']
賧: ['腅']
賨: ['寉']
賩: ['賖']
賫: ['瞢', '貰', '賷', '賚', '責']
賬: ['躼']
賭: ['暏', '賄']
賮: ['寶']
賰: ['陦', '賠']
賲: ['賞', '篢']
賶: ['艙']
賷: ['賫', '賣', '夁', '賚', '寘', '頁']
賹: ['膉', '缢']
賺: ['隒', '膁']
賻: ['膊', '磗', '牔']
購: ['贎']
賽: ['寰']
賾: ['靕']
贀: ['鬒', '贒']
贁: ['敋', '敃']
贅: ['譥']
贈: ['缯', '赠']
贊: ['赞']
贍: ['赡', '瞻']
贎: ['購']
贏: ['赢', '鸁', '嬴', '蠃', '驘', '羸']
贒: ['鬒', '贀']
贓: ['鰄']
贙: ['籫', '篢']
贚: ['朧', '龓', '蠬']
贜: ['臟']
责: ['赁', '贵']
贤: ['赀']
贪: ['贲']
贫: ['瓫']
购: ['跔', '軥']
贮: ['二']
贰: ['貳']
贱: ['戝', '赅']
贵: ['赁', '责']
贶: ['軦']
贻: ['赂', '軩']
贿: ['銪', '赌', '陏']
赀: ['贤']
赁: ['贵', '责']
赂: ['贻']
赃: ['赅', '賍']
赅: ['赃', '胲', '賋', '贱', '賅']
赈: ['陙', '賑']
赊: ['畭', '錝']
赋: ['陚', '賦']
赌: ['贿']
赎: ['騻']
赙: ['膊', '髆', '鳟', '缚']
赛: ['費']
赠: ['磳', '贈']
赡: ['贍']
赢: ['贏', '鸁', '嬴', '蠃', '驘', '羸']
赥: ['歆']
赯: ['趭']
走: ['歨']
赲: ['赴', '趐']
赴: ['赲', '赼']
赵: ['﨣']
赸: ['趇', '趦', '趑', '赿', '赼', '趁', '趍', '趙', '趗']
赹: ['超']
赺: ['趌']
赻: ['趆', '趠', '越']
赼: ['赴', '趑', '赿']
赽: ['趬', '趝']
赿: ['赼', '赸', '趗']
趀: ['趦', '趟', '趁', '趍']
趁: ['趇', '趦', '趑', '趡', '赸', '趍', '趙']
趃: ['趒', '趎']
超: ['赹']
趆: ['赻', '趫', '趡', '趠']
趇: ['趑', '赸', '趁', '趍', '趙']
趉: ['趚', '趒', '趛', '趝']
越: ['赻', '趧', '趬']
趌: ['趞', '趟', '趤', '赺']
趍: ['趀', '趇', '趦', '赸', '趁', '趙']
趎: ['趚', '趒', '趃']
趏: ['趐', '趄']
趐: ['趢', '趨', '赲', '趔']
趑: ['趇', '赼', '赸', '趁']
趒: ['趯', '趚', '趉', '趎', '趃', '趝']
趓: ['趖']
趔: ['趐']
趖: ['趓']
趗: ['赿', '趐', '赸']
趙: ['趇', '趦', '趥', '趟', '赸', '趁', '趍']
趚: ['趒', '趎', '趪']
趛: ['趉', '趒']
趝: ['赽', '趉', '趒']
趞: ['趫', '趟', '趌', '趤']
趟: ['趀', '趦', '趞', '趫', '趩', '趌', '趤', '趙']
趠: ['赻', '趆', '趫']
趡: ['趁']
趢: ['趐']
趤: ['趞', '趫', '趟', '趌']
趥: ['趦', '趙']
趦: ['趀', '趥', '趁', '趍', '趙']
趧: ['赻', '越']
趨: ['趐']
趩: ['趟']
趪: ['趯', '趚', '趒']
趫: ['趞', '趆', '趡', '趩', '趟', '趠', '趲', '趤']
趬: ['趯', '赽', '越']
趭: ['赯']
趯: ['趒', '趬', '趪']
趲: ['趫']
足: ['辷']
趴: ['跙']
趶: ['骭']
趷: ['肐']
趸: ['霆']
趹: ['趺', '跤', '殎', '眣']
趺: ['趹', '跣', '跤', '殎', '眣', '駃']
趼: ['研', '豣']
趾: ['耻']
跂: ['踆', '跤']
跃: ['跻', '眡']
跄: ['蹌']
跆: ['孡', '眙']
跇: ['鉪', '跧']
跉: ['鈴']
跊: ['秼', '眯', '跌', '陎', '跛']
跌: ['砆', '硖', '踑', '跊', '詄', '踶', '轶']
跍: ['跕', '鉒']
跎: ['鸵']
跏: ['珈']
跐: ['躡', '蹆']
跒: ['蚵', '妸', '胢', '砢']
跔: ['购']
跕: ['砧', '钴', '跍']
跗: ['鲋']
跘: ['蹃', '跮']
跙: ['駏', '鉕', '趴']
跛: ['被', '跊']
跜: ['蹘', '跇']
跞: ['跣', '踓']
跟: ['豤', '貇', '眼', '踬']
跠: ['瞚']
跢: ['踐']
跣: ['趺', '踓', '跤', '跞']
跤: ['跂', '趺', '趹', '跣', '詨', '殎']
跦: ['祩']
跧: ['跇']
跩: ['踮']
跬: ['踐', '硅']
跮: ['跘', '晊']
路: ['駱', '駱', '路']
跰: ['賆']
跲: ['殓']
跶: ['踲']
跷: ['踠']
跺: ['躲']
跻: ['跃']
跼: ['踞']
跾: ['簉']
跿: ['聢']
踀: ['踥', '踄']
踄: ['踀', '踥']
踆: ['跂', '狻']
踈: ['蹠']
踉: ['狼', '硠', '狼']
踊: ['蹋', '踴']
踌: ['踳', '踦']
踍: ['酵']
踎: ['娝']
踏: ['踳', '踷', '蹫']
踐: ['跬', '跢']
踑: ['騏', '稘', '跌', '猉', '踶']
踓: ['跣', '跞']
踗: ['騐']
踙: ['躐', '蹶']
踛: ['錴']
踜: ['踱']
踝: ['踬']
踞: ['跼']
踠: ['跷', '碗', '蹗']
踣: ['踤']
踤: ['踣']
踥: ['踀', '踄', '踱']
踦: ['踌']
踧: ['蹾']
踩: ['铼']
踪: ['蹠', '碂']
踬: ['锧', '踝', '跟']
踮: ['跩']
踰: ['踲', '躏', '隃']
踱: ['踜', '蹗', '踥']
踲: ['跶']
踳: ['踏', '踌']
踴: ['踊']
踶: ['跌', '踑']
踹: ['瑞']
踺: ['躂']
踻: ['腡']
踿: ['鍬', '跐']
蹀: ['鍱', '媒']
蹂: ['猱']
蹃: ['跘']
蹄: ['碲']
蹆: ['跐', '褪']
蹋: ['踊', '鎉']
蹌: ['跄']
蹎: ['蹺', '蹽', '磌']
蹓: ['镏', '餾']
蹗: ['踱', '踠']
蹘: ['豂', '醪', '跜']
蹜: ['摍']
蹝: ['蹤']
蹟: ['躀', '躍']
蹠: ['踪', '踈']
蹡: ['躜']
蹤: ['蹝']
蹨: ['躈']
蹩: ['蹵', '躄']
蹪: ['蹸', '躦']
蹫: ['踏', '蹻']
蹭: ['鏳']
蹳: ['躐']
蹴: ['蹾']
蹵: ['蹩']
蹶: ['踙']
蹸: ['蹪', '躦']
蹹: ['蹻']
蹺: ['磽', '蹎']
蹻: ['蹹', '驕', '蹫', '鐈']
蹽: ['蹎']
蹾: ['踧', '躈', '蹴']
躀: ['蹟', '躍']
躁: ['跺', '矂']
躂: ['踺']
躄: ['蹩']
躅: ['踴']
躈: ['蹾', '蹨', '缴']
躉: ['蕢']
躋: ['璾']
躍: ['躀', '躥', '擢']
躎: ['蹶']
躏: ['踰']
躐: ['踙', '蹳']
躔: ['躟', '纏']
躗: ['躛']
躘: ['曨', '豅', '嚨']
躙: ['鐦']
躛: ['躗']
躜: ['蹡', '缵', '躦']
躝: ['鑭']
躟: ['躔', '孃', '欀']
躡: ['跐']
躣: ['躩', '蠷']
躥: ['躍']
躦: ['躜', '躩', '蹸', '蹪']
躧: ['矖', '孋']
躩: ['矡', '躣', '躦']
躪: ['糷']
躭: ['眈']
躱: ['躲']
躲: ['跺', '躱']
躶: ['錁']
躷: ['錗']
躸: ['錡']
躼: ['賬']
躽: ['軀']
軀: ['軅', '躽']
軁: ['軃']
軂: ['蟧']
軃: ['貚', '軁']
軄: ['織']
軅: ['軀']
車: ['稟', '草', '皐', '華', '卓', '車']
軋: ['乵']
軌: ['乹']
軎: ['乬']
軏: ['靰']
軑: ['転']
軓: ['舤', '軝']
軔: ['屻']
軖: ['軠']
軚: ['軹']
軝: ['軓']
軟: ['软', '軮']
軠: ['軖']
軡: ['岒', '輇']
転: ['耘', '軧']
軣: ['蔂', '暴', '暴']
軤: ['軯']
軥: ['购']
軦: ['岲', '贶', '軧']
軧: ['軦', '転', '軭', '蚔']
軩: ['贻', '輊', '輅', '岶', '輍']
軮: ['軟']
軯: ['軤', '鮃']
軷: ['輁']
軸: ['靹']
軹: ['軚']
軺: ['齠', '駋', '鞀']
軼: ['倝']
軽: ['輕']
軿: ['鉼', '鮵', '帡', '餅', '輧', '骿']
輁: ['軷']
輂: ['董', '茟', '章']
較: ['輆']
輄: ['輆']
輅: ['赂', '軩']
輆: ['較', '輄']
輇: ['軡']
載: ['酨', '韯']
輊: ['軽', '軩']
輍: ['軵', '峪', '軩']
輎: ['帩', '輔']
輑: ['齬']
輔: ['輎', '辅']
輕: ['軽']
輖: ['錭']
輗: ['齯']
輘: ['崚', '輬']
輜: ['輻', '輻']
輝: ['鯶']
輞: ['輣']
輠: ['蜾']
輣: ['輞']
輤: ['鰽', '精']
輦: ['輦']
輧: ['軿', '餠']
輨: ['捾']
輪: ['輪']
輬: ['軶']
輯: ['輵']
輲: ['轃']
輳: ['轃']
輵: ['輯', '鞨']
輷: ['鞫']
輺: ['轓', '轐']
輻: ['輻']
輾: ['轣']
轂: ['鷇', '毀', '糓']
轃: ['轈', '輲', '輳']
轄: ['螛']
轉: ['轌']
轊: ['轅']
轋: ['韃']
轌: ['鱈', '轉']
轍: ['鏾']
轎: ['矯']
轐: ['輺']
轒: ['蟦']
轓: ['輺', '轕', '輰']
轔: ['嶙', '鳞']
轕: ['轓']
轖: ['繬', '檣']
轘: ['糫']
轚: ['繫', '毉']
轜: ['轒']
轞: ['糮']
轢: ['轢']
轣: ['輾']
轤: ['韆']
车: ['牟']
轨: ['轼']
轩: ['吁', '訏', '訐', '吀', '紆', '虷', '竏']
轪: ['软']
轮: ['纶']
软: ['较', '軟']
轰: ['姦']
轱: ['咕', '秙', '詁', '姑']
轶: ['跌']
轸: ['跈']
轺: ['紹']
轻: ['硁']
轼: ['轨']
轿: ['峤', '娇']
辂: ['貉']
较: ['软', '铰', '皎', '鉸', '鲛']
辅: ['铺', '輔']
辍: ['啜']
辏: ['辕']
辕: ['辏']
辘: ['鏕']
辚: ['疄']
辛: ['孛', '李']
辣: ['鋉', '鍊']
辦: ['辬', '辮', '瓣']
辨: ['辩', '辫']
辫: ['辨']
辬: ['辦', '辮']
辮: ['辬', '辦']
辰: ['展']
辶: ['仁', '乛', '乀', '込', '辺', '广', '辽', '汪', '江', '迉', '乚', '汇', '匸']
辷: ['迀', '话', '迟', '足', '亅']
辸: ['迈']
边: ['迠', '过']
辺: ['辶', '込', '迈', '迉']
辻: ['迂', '远', '汢']
込: ['辶', '辺', '迉']
辽: ['泾', '江', '迉', '汇']
达: ['沾', '沽']
辿: ['迫', '迋']
迀: ['还', '迂', '恎', '辷', '话', '迟']
迁: ['泛']
迂: ['还', '迀', '汢']
迃: ['疋']
迄: ['迿']
迅: ['汛', '讯', '沑']
迆: ['迪']
过: ['泣']
迈: ['辺', '辸']
迉: ['氾', '辶', '込', '辺', '辽', '汜', '辸', '汇']
迋: ['辿', '迓']
迌: ['浢', '饾']
迍: ['傀']
迏: ['述']
近: ['远', '迟']
迓: ['迋']
迗: ['疘', '迁', '俖']
还: ['迂', '仨', '迀']
进: ['迸', '送', '逬', '迯']
远: ['近', '迟']
违: ['痣']
迟: ['近', '远', '迀', '辸', '辷']
迠: ['边']
迡: ['廻', '迥']
迣: ['逇', '遺']
迤: ['逧']
迥: ['迵', '迡']
迨: ['追', '遀', '逍']
迪: ['逆', '逈', '迆']
迫: ['辿']
迬: ['逑', '迲', '運']
迭: ['洣']
迮: ['逑', '迲']
迯: ['巡', '进', '迸', '逬']
述: ['迏']
迲: ['迮', '迬', '逑']
迳: ['通']
迵: ['迥']
迶: ['遃', '逋', '遒']
迷: ['遱']
迸: ['进', '送', '迯']
迻: ['逄']
迼: ['溰']
追: ['遆', '遃', '遒', '迨']
迾: ['逖']
迿: ['迄']
退: ['還', '過']
送: ['进', '迸', '逬']
逃: ['遞', '遶']
逄: ['連']
逇: ['迣', '逤']
逈: ['迪']
选: ['透']
逊: ['遜', '遚', '邊', '邎', '遝', '逡', '邆', '遡', '逫']
逋: ['迶', '遒', '逍']
逌: ['遖', '淖', '適']
逍: ['逋', '溑', '遒']
逎: ['涽', '澑']
透: ['选', '逶']
逑: ['迮', '迬', '遺', '迲', '遅']
递: ['滢']
逓: ['遚']
途: ['逨']
逕: ['邁']
逖: ['逤', '迾']
逘: ['遴', '速', '逶']
這: ['遍', '遧']
通: ['邇']
逜: ['逼']
逞: ['遙', '遥', '温']
速: ['疲', '逨', '逘']
逡: ['遚', '遪', '逊']
逢: ['達', '違', '遳']
連: ['湱', '逄']
逤: ['逇', '逖']
逦: ['惬']
逧: ['遺', '迤', '逬']
逨: ['速']
逩: ['遆', '遃']
逪: ['遛']
逫: ['逊', '邆', '選']
逬: ['进', '逧', '送', '迯']
逭: ['逳']
週: ['遁', '邇']
進: ['遧']
逳: ['遖', '逾', '遃', '逭', '逽']
逴: ['遉', '遧']
逵: ['遙', '遠', '谥']
逶: ['遴', '透', '遥', '遹', '逊', '逘']
逻: ['逐']
逼: ['道', '逜']
逽: ['逳']
逾: ['遖', '逳']
遀: ['遌', '遺', '遤', '邉', '迨', '澴']
遁: ['週']
遃: ['迶', '遆', '追', '遒', '逩']
遅: ['逑', '邉']
遆: ['遃', '追', '逩']
遈: ['澋', '途', '毽', '違', '遶']
遉: ['逴']
運: ['迬', '遌', '邁', '遺']
遌: ['遤', '遒', '運', '遀']
遍: ['遱', '溏', '這']
過: ['還', '遱', '退', '濄']
遏: ['遺', '遛', '遤', '邉', '遀']
遒: ['迶', '遌', '遃', '追', '逋', '逍']
道: ['逼']
達: ['遠', '逢', '逵']
違: ['逢', '遈', '遶']
遖: ['逳', '逾', '逌', '適']
遗: ['遚', '邊', '選']
遙: ['遥', '逵', '邋', '逞']
遚: ['遗', '逓', '逡', '邅']
遛: ['逪']
遜: ['遗', '遹', '逊']
遞: ['逃']
遠: ['遢', '達', '逵']
遡: ['邎']
遢: ['遠']
遣: ['遙', '遹', '湩', '邋', '遷']
遤: ['遌', '邁', '遺', '遏', '邉', '遀']
遥: ['遙', '邋', '逶', '逞']
遦: ['遱']
遧: ['進', '逴', '這']
適: ['遖', '逌']
遪: ['遮', '邈', '邊', '逡', '邆', '逫', '邅']
遬: ['邀']
遭: ['還']
遱: ['遍', '還', '遺', '過', '邉', '迷', '遦']
遳: ['逢', '遾']
遴: ['遹', '逘', '逶']
遶: ['違', '遈', '逃']
遷: ['遹', '遣', '逊', '邆', '逫', '邅', '選']
選: ['遗', '逫']
遹: ['遜', '遴', '谵', '逶', '逃']
遺: ['迣', '逑', '逧', '遤', '遏', '運', '遀']
遾: ['遄', '遳']
邀: ['遬']
邁: ['逕', '遤', '運']
邂: ['邇']
還: ['遱', '過']
邅: ['遗', '遚', '遪', '邆', '逫', '遷']
邆: ['遪', '逊', '逫', '邅', '遷']
邇: ['邂', '週', '通']
邈: ['遪', '邎']
邉: ['遱', '遤', '遏', '遀', '遅']
邊: ['遗', '瀅', '遪', '逊']
邋: ['遙', '遥', '遣']
邎: ['邈', '逊', '遡']
邏: ['邏', '籩']
邓: ['邦']
邗: ['邩']
邜: ['夗']
邝: ['邜', '门']
邞: ['郑', '邟']
邟: ['邞', '邧']
邢: ['郉']
邤: ['邱']
邦: ['邓']
邧: ['邟']
邨: ['鄁', '郇']
邩: ['邗']
邪: ['郖']
邬: ['郛', '都']
邭: ['郇']
邯: ['郋']
邰: ['郃', '郐']
邱: ['邤']
邳: ['邲']
邴: ['郠', '鄖']
邵: ['鄑', '郚']
邷: ['郉', '郯']
邸: ['邼', '郝']
邹: ['郋', '邸']
邼: ['邸']
郁: ['郎', '郣']
郃: ['邰', '郐']
郆: ['郤', '郗']
郇: ['邨']
郉: ['邷', '邢']
郊: ['郟']
郋: ['邯', '邹']
郎: ['郁']
郐: ['郃', '邰']
郑: ['邞']
郔: ['倻']
郖: ['郻', '邪']
郘: ['郅']
郚: ['鄑']
郛: ['郢', '邬']
郜: ['邾']
郝: ['邸']
郞: ['郎']
郟: ['郊']
郠: ['郻', '邴']
郢: ['郛', '郵', '鄧']
郣: ['郁']
郥: ['鄙', '郹', '郧']
郧: ['郥', '鄭', '鄙', '鄚']
郪: ['鄞', '酁']
郫: ['鄋']
郬: ['鄁']
郭: ['鄫']
郲: ['鄎']
郴: ['梆', '桞', '槨']
郵: ['郢', '鄧']
郷: ['鄉', '鄊']
郸: ['鄈']
郹: ['郥', '鄡']
郻: ['鄎', '郠', '鄖']
都: ['邬']
鄁: ['郬']
鄆: ['鄲', '郧']
鄈: ['郸']
鄉: ['鄊', '郷']
鄊: ['鄉', '郷', '嫏']
鄋: ['郫']
鄎: ['郲', '郻']
鄐: ['鄔']
鄑: ['鄷', '郚']
鄔: ['鄐']
鄕: ['榔']
鄖: ['郻', '邴', '酄']
鄙: ['鄲', '郥', '鄢', '鄡', '郧']
鄚: ['鄭', '郧']
鄛: ['鄹', '鄢', '鄡']
鄞: ['郪']
鄡: ['鄲', '鄢', '鄙', '郹']
鄢: ['鄙', '鄡']
鄧: ['郵', '郢', '鄷', '酆']
鄪: ['鄷', '酆']
鄫: ['郭']
鄭: ['鄚', '郧']
鄮: ['酂', '揶', '酇']
鄰: ['鄪', '酆']
鄲: ['鄆', '鄙', '鄡', '郧']
鄵: ['鄻']
鄷: ['鄪', '鄑', '鄧', '酆']
鄹: ['鄛']
鄺: ['酂']
鄻: ['鄵']
酁: ['郪']
酂: ['鄺', '鄮', '酇']
酃: ['酆']
酄: ['郻', '鄖']
酆: ['鄰', '酃', '鄪', '鄷', '鄧']
酇: ['酂', '鄮']
酋: ['首']
酎: ['尀']
酐: ['酑', '皯']
酑: ['酐']
酖: ['酷', '酢', '酞']
酚: ['鼢']
酜: ['醜']
酞: ['酖']
酡: ['跎']
酢: ['酖']
酧: ['酹']
酨: ['載']
酪: ['駱', '駱', '酪']
酭: ['醏']
酮: ['硐']
酵: ['踍']
酷: ['酖']
酹: ['酧']
酼: ['醶']
酿: ['醸']
醁: ['騄']
醆: ['醌']
醇: ['醷']
醊: ['醥', '醲']
醌: ['醆']
醏: ['醴', '酭', '醴']
醑: ['醹']
醒: ['醖']
醓: ['醙']
醖: ['醒']
醘: ['醷', '醠', '醹']
醙: ['醓']
醜: ['酜']
醠: ['醣', '醘']
醢: ['醯']
醣: ['醠']
醥: ['醊', '磦', '醳']
醪: ['蹘']
醭: ['醱']
醮: ['醺', '醵']
醯: ['醴', '醴', '醢']
醱: ['醭']
醲: ['醊', '齈', '醽']
醳: ['醥']
醴: ['醴', '醯', '醏']
醵: ['醿', '醺', '醮', '醾', '釀']
醶: ['酼']
醷: ['醇', '醘']
醸: ['酿']
醹: ['醘', '醑']
醺: ['醮', '醵']
醻: ['釂']
醽: ['醲']
醾: ['醿', '醵', '釀']
醿: ['醾', '醵', '釀']
釀: ['醿', '醾', '醵']
釁: ['囊']
釂: ['醻']
釃: ['驪']
釉: ['鈾']
釋: ['懌']
里: ['虽', '瞾', '里']
重: ['璗']
量: ['曐', '蠒', '量']
釒: ['纟']
釔: ['鲇', '鈺', '釲', '鉛', '釭']
釖: ['舠']
釗: ['刹']
釘: ['釨', '舡', '釤', '耓']
釛: ['鱽']
針: ['釪', '釴', '鈓', '釺']
釞: ['鈦', '釱', '釴']
釟: ['鈊', '鈖', '鈶']
釠: ['釩', '飢', '鈧', '釲', '钒']
釢: ['屷']
釤: ['釘', '釮']
釨: ['釘']
釩: ['釾', '釠', '钒', '鉛']
釪: ['鈓', '飦', '針']
釫: ['銆']
釬: ['鉟', '鼾', '鈈']
釭: ['鉦', '鈺', '钰', '鉟', '魟', '釔', '鈂']
釮: ['釤', '鉒']
釱: ['鈦', '釞']
釲: ['鉦', '鉟', '釠', '釔', '鉛', '鱾']
釳: ['鉈']
釴: ['鈦', '釽', '釞']
釶: ['銠']
釸: ['鈂']
釺: ['鈢', '飪', '鈓', '飦']
釽: ['釴', '鉕']
釾: ['釩']
釿: ['紤', '蚚', '訢']
鈀: ['蚆', '妑']
鈁: ['蚄', '纺']
鈂: ['釸', '鉒', '釭']
鈃: ['豣', '钘', '鉐', '鈨']
鈄: ['斜']
鈆: ['鈜', '銽']
鈇: ['鈌', '鋖']
鈈: ['釬']
鈊: ['銗', '鉢', '鈍', '鈶']
鈌: ['鈇', '鈛', '欴', '鋏', '鉉', '鉠', '鉃']
鈍: ['鲀', '鉽']
鈎: ['鉓', '鉤']
鈐: ['銡', '鉒', '肣', '鉛', '鉺']
鈑: ['飯', '鋜']
鈓: ['釪', '紝', '飪', '妊', '釺', '針']
鈔: ['釶', '鉸', '紗']
鈕: ['鉝', '妞', '纽', '狃']
鈖: ['訮', '詽', '釟', '纷', '秎']
鈗: ['鋵', '釹', '鉖', '錺']
鈘: ['銶', '銥', '鈽']
鈙: ['鉄']
鈚: ['纰']
鈛: ['鈌', '鋖', '銾', '鍂']
鈜: ['欽', '銪']
鈞: ['蚐']
鈟: ['岬']
鈠: ['銩', '鍉']
鈢: ['鋅', '釺', '鋡']
鈤: ['蚎']
鈥: ['鈔', '錜', '鉌', '鋲', '鉸', '鉉', '鉵']
鈦: ['釱', '釴', '釞']
鈧: ['釠']
鈨: ['鈃']
鈪: ['蚅']
鈬: ['蚇']
鈮: ['妮']
鈯: ['飿', '錎']
鈰: ['鉨']
鈲: ['鉁']
鈳: ['鲄', '鴚', '舸']
鈴: ['鋭', '鉾', '鉁', '龄', '鉣', '跉']
鈶: ['鈊', '鉿', '釟', '鋡', '鲐']
鈷: ['銛', '蛅', '鉆']
鈸: ['鲅', '銯', '鎖', '钹']
鈹: ['鉂', '錸', '錐', '鑁', '柀']
鈺: ['魟', '釔', '鉒', '釭']
鈻: ['鉊', '鋁']
鈽: ['鉖']
鈾: ['舢']
鈿: ['鮂']
鉀: ['銱']
鉁: ['鉾', '鈲', '鈴']
鉂: ['鈹', '錸']
鉃: ['鈌', '鋏']
鉄: ['鈙', '錰']
鉅: ['蚷']
鉆: ['鈷', '銛', '鉐', '蛅']
鉈: ['岮']
鉉: ['銃', '舷', '鈥', '鈌', '鋏', '鉸', '鉠', '鉵', '鲛']
鉊: ['鉑', '貂', '蛁', '韶', '鋁', '鈻']
鉌: ['鈥', '鉥']
鉎: ['銓']
鉏: ['组', '殂', '鉭']
鉐: ['鈃', '銆', '釲', '鉆']
鉑: ['貃', '鉊', '鋁']
鉒: ['鈺', '跍', '蚛']
鉓: ['銂', '鉤', '鈎']
鉕: ['釽', '跙', '銍']
鉖: ['鈗', '终', '鈽']
鉘: ['紼']
鉚: ['飹', '鋓', '鋤']
鉛: ['釩', '銡', '釔', '鋊', '釲', '鈐']
鉜: ['鲋', '跗']
鉝: ['鈕']
鉞: ['钺']
鉟: ['釬', '錏', '魾', '釲', '釭']
鉠: ['鎪', '鈌', '鋏', '鉸', '鋟', '鉉', '鉷', '鲛', '鋔']
鉡: ['錛', '鍩']
鉢: ['鈊']
鉣: ['鉱', '鲩', '鈴']
鉤: ['鉓', '鈎']
鉥: ['鉌', '鉪', '鍗', '錚']
鉦: ['釭']
鉨: ['鈰']
鉪: ['鍓', '跇', '鐙', '鋰', '鉵']
鉭: ['鉏', '炟']
鉯: ['姒']
鉱: ['鉣', '鉲']
鉲: ['鉱']
鉵: ['鈥', '鉪', '鉉']
鉷: ['銝', '鉠', '銚']
鉸: ['銃', '鈥', '賋', '鋏', '较', '銧', '鉉', '鉠', '鲛']
鉺: ['餌', '鈐']
鉼: ['軿', '餅', '骿']
鉽: ['鈍']
鉾: ['鋭', '錍', '鉁', '鎨', '鈴']
鉿: ['鈊', '釟', '鈶', '绐', '鋡', '鲐']
銀: ['鍶', '錕', '鋇']
銁: ['銲']
銂: ['銣', '鉓', '鋛', '銄']
銃: ['銥', '鉸', '鉉', '絖', '统']
銄: ['銂', '銦', '姠']
銆: ['釫', '銛', '銗', '鉐', '岹', '蛨']
銇: ['錶', '鏯', '錸', '餗', '錝', '鍄', '鎄']
銉: ['肄', '綽', '鋽', '錞', '鑏']
銍: ['秷', '鉕']
銎: ['蛩']
銐: ['鑒']
銑: ['駪']
銒: ['姸']
銓: ['鉎', '鲑']
銔: ['錏']
銕: ['鎲', '鍗']
銖: ['銤']
銗: ['銛', '鈊', '銆']
銘: ['錎']
銙: ['鳑', '姱']
銚: ['銝', '鋺', '鎤', '鉷']
銛: ['鈷', '銗', '餂', '銆', '鉆']
銝: ['鎸', '鉷', '銚']
銞: ['鍳', '錖']
銟: ['賗']
銠: ['釶']
銡: ['鈐']
銢: ['錴', '鎵', '鋖', '銾', '鋔']
銣: ['銂', '拁']
銤: ['銖']
銥: ['銃', '銶', '鈽', '鈘', '餏']
銦: ['錩', '鋗', '鲴', '銄']
銧: ['錜', '鋏', '鉸', '鎠', '胱']
銨: ['鎞']
銩: ['銾', '鍄', '鎄', '鈠']
銪: ['鈜']
銬: ['銷', '鎊']
銯: ['鈸', '錰', '錝']
銱: ['鉀']
銲: ['銁']
銴: ['鏨']
銵: ['裑']
銶: ['銥', '鈘', '鍃']
銷: ['錍', '销', '艄', '錹', '銬', '蛸']
銹: ['鋧']
銻: ['绨', '挮', '娣']
銼: ['鎺', '鋞', '鎐']
銽: ['鈆', '錳', '緍']
銾: ['銢', '鋖', '銩']
銿: ['鲬']
鋀: ['餖']
鋁: ['鉑', '鉊', '捛', '鈻']
鋃: ['錟']
鋄: ['鲠', '鎫', '錗', '鎦', '鋟', '鈒', '鋖', '鍟', '錽', '顉', '鍐', '鍂', '鍚']
鋆: ['鐅']
鋇: ['錕', '銀']
鋈: ['鍙']
鋉: ['辣', '錬', '鏣', '鋶', '鍊']
鋊: ['銡', '绤', '鉛']
鋋: ['娫']
鋌: ['娗']
鋏: ['鈌', '鉸', '銧', '鎤', '鉉', '鉠', '鉃', '鲛']
鋐: ['鋺']
鋑: ['鈸', '錄', '鎖', '錟']
鋓: ['鉚', '錭']
鋔: ['銢', '鋺', '鉠']
鋖: ['鋄', '骽', '鈇', '鈛', '銢', '鎫', '錗', '錽', '銾', '鍐', '鍂']
鋗: ['銦']
鋙: ['鋸', '鲪']
鋛: ['銂']
鋞: ['鏐', '鎺', '鎐', '錕', '鏗', '銼']
鋟: ['鋄', '鎪', '鎤', '鏙', '鉠']
鋠: ['鍶', '鎠']
鋡: ['鈢', '鉿', '鈶']
鋣: ['鎯', '鎁']
鋤: ['鉚']
鋥: ['鲣', '铿', '挰']
鋧: ['銹', '麲']
鋨: ['鍐']
鋪: ['鋿', '舗']
鋫: ['錅', '鍪']
鋭: ['鉾', '蜕', '鈴', '脱']
鋮: ['鏚', '鍼']
鋯: ['艁']
鋰: ['鑎', '鉪', '鍟', '鏜', '錙', '鍜']
鋲: ['鈥']
鋴: ['鍗']
鋵: ['鈗']
鋶: ['錼', '鐐', '鏣', '鋉', '鍊']
鋸: ['鋙', '艍', '蜛', '腒']
鋹: ['鍉', '錣']
鋺: ['鏥', '睕', '鋐', '鎵', '鎞', '鋔', '銚']
鋻: ['鍳', '錖', '鐅']
鋽: ['錞']
鋿: ['鏑', '鋴', '鍗']
錀: ['綸']
錁: ['録', '鍒', '鐛', '錄', '躶', '鍊']
錂: ['銨', '鑯', '鎮', '鏯', '鑁', '錽', '鍄', '鎄']
錃: ['鍌', '鐜']
錄: ['鍖', '録', '錁', '鍊', '鋑']
錅: ['鋫', '鍫']
錇: ['餢']
錉: ['鑎', '鏆', '鎠', '鑥']
錊: ['睟']
錋: ['鎙', '鐧', '鐦']
錌: ['鐏']
錍: ['鉾', '銷', '貏']
錎: ['鈯', '銘', '餡']
錏: ['銔', '鉟', '鲕', '孲']
錐: ['鈹']
錑: ['睙']
錒: ['锕']
錓: ['鏛', '鍉', '猐', '鎈']
錔: ['鎋']
錕: ['鲲', '鋞', '鋇']
錖: ['鍳', '鋻']
錗: ['鋄', '鍥', '鋖', '錘', '躷', '鍕']
錘: ['錗', '鎹', '鋖']
錙: ['鲻', '锱']
錚: ['鉥', '挣']
錛: ['鉡', '銪', '餴']
錜: ['鎲', '銧']
錝: ['鐐', '艅', '赊', '鏕', '銇', '銯']
錞: ['鰉', '肄', '鋽', '銉']
錟: ['鎖', '鋃', '鏷', '鋑']
錡: ['錹', '躸']
錢: ['餞', '鉸']
錣: ['鍛', '鑹', '鑃', '鏢', '鋹']
錤: ['鶀', '鐉', '鲯']
錥: ['焴']
錧: ['館']
錨: ['緢', '鎠', '锚', '鑥']
錩: ['銦']
錪: ['鐭']
錫: ['鐍']
錬: ['鎍', '鏣', '鋉', '鍊']
錭: ['鍋', '鋓', '鎇', '鎉']
錯: ['耤']
錰: ['錼', '錸', '鉄', '銯']
録: ['錁', '鍒', '錄']
錳: ['銽']
錴: ['鏥', '踛', '銢', '鍠', '鏜']
錶: ['鏯', '鑁', '銇']
錸: ['錼', '鈹', '鉂', '錰', '銇', '蛛']
錹: ['銷', '鎗', '錡']
錺: ['鈗', '踖']
錼: ['錸', '錰', '鋶']
錽: ['鋄', '鲠', '鋖', '鍐']
錿: ['虠', '鎮', '鐿']
鍁: ['鏾']
鍂: ['鋄', '鈛', '錴', '鎦', '鋖', '鍐', '鋔']
鍃: ['銶']
鍄: ['銩', '銇', '鎄']
鍇: ['鎗']
鍈: ['锳', '鑅', '韺', '鏌', '鍱']
鍉: ['緹', '鋹', '錓', '鈠']
鍊: ['錁', '鐐', '錄', '揀', '辣', '錬', '鏣', '捒', '鋉', '鋶']
鍋: ['錭']
鍌: ['錃', '鐜', '鏊']
鍍: ['鍊']
鍏: ['鏱', '鎑', '鐃']
鍐: ['鋄', '銨', '鎫', '鑕', '鋨', '鋖', '錽', '鍂']
鍑: ['鏝']
鍒: ['録', '錁', '鍨', '揉']
鍓: ['鎶', '鎒', '鉪']
鍔: ['鳄', '锷', '鐞', '鋧']
鍕: ['錗', '鏆', '鎷']
鍖: ['錄', '鎖']
鍗: ['鉥', '鋴', '銕']
鍙: ['鐢', '鎏', '鋈']
鍚: ['鋄', '鐋', '婸', '鎤', '鐊']
鍛: ['錣']
鍜: ['鋰']
鍝: ['鐫']
鍞: ['鏓']
鍟: ['鎾', '鎦', '鍠', '鏙', '鏜', '鋰', '鏂']
鍠: ['鎪', '鎴', '錴', '鎦', '鎕', '鍟', '鏜', '鏙']
鍡: ['鳂']
鍢: ['鍻', '鲾']
鍨: ['鍒']
鍩: ['鉡']
鍪: ['鋫']
鍫: ['錅']
鍬: ['鎃', '鏉', '踿', '鳅']
鍭: ['鏹']
鍮: ['媮', '榆']
鍰: ['鍾']
鍱: ['鏿', '鎍', '鑅', '蹀', '鏫', '錬', '鍈']
鍳: ['盭', '銞', '鋻', '錖', '鐅']
鍴: ['媏', '鎷']
鍵: ['鐬']
鍶: ['鎲', '鐍', '鑎', '鎠', '銀']
鍻: ['鍢']
鍼: ['鋮', '戫', '羬']
鍽: ['媥', '鍊']
鍾: ['鑃', '鍰']
鎀: ['鏅']
鎁: ['鎯', '揶', '鋣']
鎂: ['镁']
鎃: ['鎡', '鐝', '鍬', '鏹']
鎄: ['鏯', '錂', '銇', '鍄']
鎆: ['鍻', '鍢']
鎇: ['錭']
鎈: ['鏛', '鏤', '錓']
鎉: ['錭', '蹋', '鳎']
鎊: ['銵', '鐒', '銬']
鎋: ['錔']
鎌: ['鰜', '鎟', '縑']
鎍: ['鏍', '錬', '鍱']
鎎: ['鑧']
鎏: ['鑒', '堻']
鎐: ['鎺', '鋞', '銼']
鎑: ['鎬', '鐃']
鎒: ['鐀', '鍓', '鎘', '鍜', '鑥']
鎓: ['塕']
鎕: ['鎪', '餹', '鎴', '鎮', '鋐', '鍠', '鏠', '鏈']
鎖: ['鍖', '鈸', '錟']
鎗: ['鍇', '錹', '獊']
鎘: ['鎒']
鎙: ['錋', '鐧']
鎚: ['鏂']
鎛: ['糐', '餺']
鎜: ['鏧', '壟', '鐾', '壟']
鎞: ['鎹', '鋺', '鎢']
鎟: ['鎌', '襙', '搡', '鎳']
鎠: ['鋠', '鍶', '鑎', '錨', '銧']
鎡: ['鎃', '鎰']
鎢: ['鎞', '隖']
鎤: ['鋏', '鋟', '銚']
鎦: ['鋄', '鎾', '鍠', '鍟', '鏙', '鎷', '鍂']
鎧: ['鑕']
鎨: ['鐏', '鉾', '鍇']
鎩: ['鑕', '鏉']
鎪: ['鎴', '鎮', '鎽', '鍠', '鋟', '鎕', '鐨', '鉠']
鎫: ['鑕', '鍐', '鏂']
鎬: ['鰝', '鎸', '鎑', '鐃']
鎮: ['鎪', '鎴', '鎕', '鏆', '鐼', '錿', '鐃', '鑧']
鎯: ['鋣', '鎁']
鎰: ['鎡', '镒', '搤', '鍡']
鎱: ['鏯', '鐿']
鎲: ['錜', '鍶', '銕']
鎳: ['鎟', '諱', '暞']
鎴: ['鎪', '鎮', '鍠', '鎕']
鎵: ['鏥', '銢', '鋺', '嫁', '鲸']
鎶: ['鍓']
鎷: ['鍴', '鎾', '鎦', '鍕', '鐈']
鎸: ['銝', '鎬', '鐃']
鎹: ['鎞', '鏙', '鏠']
鎺: ['鋞', '鎐', '銼']
鎻: ['鑕']
鎼: ['鏬', '鑓']
鎽: ['鎪', '鍠', '鐔']
鎾: ['鎦', '鍟', '鎷', '鏂']
鏁: ['鑂', '钂', '鐮']
鏂: ['鎫', '鎾', '貙', '鎚', '鍟']
鏄: ['嫥', '鏬', '鐔']
鏅: ['鎀']
鏆: ['鑕', '鎮', '鐼', '錉']
鏈: ['鎕', '鏠']
鏉: ['鍬', '鑞', '鎩']
鏊: ['鐜']
鏌: ['縸', '鑖', '鍈']
鏍: ['鏿', '鎍', '缧', '镙']
鏎: ['擇', '鏐', '蹕']
鏏: ['鐠']
鏐: ['缪', '鋞', '鋷', '鎁', '鏎']
鏑: ['鋿']
鏒: ['鍬', '鑽', '鏤', '黲', '鑁']
鏓: ['鍞']
鏔: ['鐽']
鏕: ['辘', '錝']
鏖: ['廩', '廪', '鷢', '麇', '蠯', '麋']
鏗: ['鋞']
鏙: ['摧', '鎦', '鍠', '鎹', '鍟', '鏜', '鏠']
鏚: ['鋮', '摵']
鏛: ['鑕', '鎈']
鏜: ['錴', '鍠', '鍟', '鏙', '鋰']
鏝: ['鍑', '鐵']
鏞: ['鑛', '鐭', '鐬']
鏠: ['鎹', '鎕', '鐩', '鏙']
鏡: ['竸', '鐿', '鐃']
鏢: ['鐐', '鑹', '鑃', '鐪', '錣']
鏣: ['鐬', '嫬', '錬', '鋉', '鋶', '鍊']
鏤: ['摟', '鉂', '鑽', '耬', '鑀', '鑁', '鑩']
鏥: ['錴', '鋺', '鎵']
鏧: ['鎜', '鑋', '墬']
鏨: ['墼', '鎜', '銴']
鏪: ['鵭', '螬', '鐘', '鰽']
鏫: ['鏿', '鑅', '鑗', '鍱']
鏬: ['鎼', '鑓', '鏄', '鐨']
鏭: ['錰', '鑁']
鏮: ['鑛', '鑰', '鏼']
鏯: ['錶', '錂', '銇', '鎄', '鎱']
鏱: ['鱆', '鎬', '鍏', '鐼', '鎑', '鐃']
鏲: ['撁']
鏳: ['蹭']
鏴: ['鑎']
鏵: ['鐯', '韡']
鏶: ['謢', '鑣']
鏷: ['錟']
鏹: ['鎃', '鍭', '镪']
鏻: ['鱗', '撛', '鐨', '繗']
鏼: ['鏮', '鐰']
鏽: ['鐪']
鏾: ['轍']
鏿: ['鏍', '鑅', '鏫', '鍱']
鐀: ['瞶', '鎒', '鑦']
鐃: ['饒', '鎸', '鎮', '鎬', '鍏', '鎑']
鐅: ['鋆', '鍳', '鋻', '錖']
鐇: ['鑡']
鐈: ['嬌', '驕', '蹻', '鎷']
鐉: ['錤']
鐊: ['鐋', '钀', '鑈', '鍚']
鐋: ['鐊', '鍚']
鐌: ['鑰', '襐']
鐍: ['鍶', '錫']
鐎: ['鐰']
鐏: ['錌', '鳝', '鎨', '鳟']
鐐: ['嫽', '鑔', '缭', '鐵', '錝', '鏢', '爒', '鋶', '鍊']
鐒: ['撈', '耮', '鎊']
鐓: ['鐵']
鐔: ['鐳', '蟫', '鎽', '鐈']
鐖: ['饑', '鑼']
鐗: ['錋', '鐧', '鐦']
鐘: ['鵭', '鎍', '鐬', '饉', '鏪']
鐙: ['鑦', '鑎', '鉪']
鐛: ['錁']
鐜: ['錃', '鏊']
鐞: ['鍔']
鐟: ['鑙', '鏓', '鐡']
鐠: ['鏏']
鐡: ['鐟']
鐢: ['桽', '鍙']
鐥: ['鱔']
鐦: ['錋', '鐧', '躙', '鐗']
鐧: ['撊', '錋', '鎙', '鐗', '鐦']
鐨: ['鎪', '鐀', '鏬', '鏻', '纘', '鐼', '鑥']
鐩: ['鏠']
鐪: ['鏽', '鏢', '艣']
鐫: ['鍝']
鐬: ['鍵', '鐭', '鐘', '饖', '鏣', '鱥']
鐭: ['鐬', '錪', '錟']
鐮: ['钂', '鏁', '鑣']
鐯: ['鏵']
鐰: ['鐷', '鐎', '缲', '操', '鑠', '鏼', '躁']
鐱: ['嬐']
鐳: ['艡']
鐴: ['擗']
鐵: ['鐐', '鏝', '鐓']
鐶: ['镮', '鑕', '擐']
鐷: ['鐰']
鐸: ['鐲']
鐹: ['撾']
鐻: ['躆', '據']
鐼: ['饙', '豶', '鎮', '鏆', '鐨', '鰿', '鑐', '鑟']
鐽: ['縫', '鏔', '繨']
鐾: ['鑒', '壟', '鎜', '鑋', '壟']
鐿: ['臆', '鏡', '嬑', '錿', '鑧', '鎱']
鑀: ['鏤', '镘', '鑁', '鑞']
鑁: ['鈹', '鏒', '鏤', '鑀', '鏭']
鑂: ['獯', '鏁']
鑃: ['鍾', '鑹', '鏢', '鋹', '錣']
鑄: ['鑢', '幬', '擣']
鑅: ['鏿', '鎍', '鏫', '鍱', '鍈', '觻']
鑇: ['鐿', '艩']
鑈: ['钀']
鑊: ['頀', '鑼']
鑋: ['鏧', '瓕', '鑒', '墼', '壟', '鎜', '鐾']
鑎: ['鍶', '鏴', '鎠', '鐙', '鋰', '錉']
鑏: ['獰', '銉']
鑐: ['鏆', '鐼', '鑟']
鑑: ['鑕']
鑒: ['銐', '鎏', '鐾', '鑋']
鑓: ['鎼', '鏬', '鑕', '鐶']
鑔: ['鐐']
鑕: ['鎧', '鎫', '鏛', '鏆', '鎩', '鎻', '鍐', '鐶', '鑑']
鑖: ['鏌']
鑗: ['鏫']
鑘: ['蠝']
鑙: ['鐟']
鑚: ['纉']
鑛: ['鏮', '鏞', '獷']
鑞: ['鐝', '镴', '鑀', '獵', '擸', '鏉', '鑩']
鑟: ['鏆', '鐼', '鑐']
鑠: ['纅', '鐰']
鑣: ['鎳', '纊', '鏶', '鑰', '鐮', '鑵']
鑥: ['鎒', '鑦', '鑎', '錨', '鋰', '錉']
鑦: ['鑬']
鑧: ['鎎', '鎮', '鐿']
鑩: ['鐝', '鏤', '鑞']
鑫: ['嶳']
鑬: ['鑦']
鑭: ['躝']
鑯: ['纖', '钀']
鑰: ['鏮', '鐌']
鑵: ['罐', '鑣']
鑹: ['鑃', '鏢', '錣']
鑺: ['钁', '鑃', '獾']
鑼: ['饠', '鐖', '鑊']
鑽: ['鏘', '鏒', '鏤', '鑁', '鎻']
钀: ['鑯', '鑈', '鐊']
钁: ['鑺']
钂: ['鏁', '鐮']
钅: ['饣']
钆: ['钐', '钋']
钇: ['钻']
针: ['钝']
钉: ['钰', '钍', '灯', '钌']
钋: ['钐', '钆', '钌']
钌: ['钐', '钰', '钉', '钋']
钍: ['钐', '钰', '钴', '钉', '钕', '铦', '铈']
钎: ['圲', '秆', '屽', '忓', '豻', '扞', '忏', '扜', '祍', '圩']
钏: ['钢']
钐: ['钰', '钍', '钴', '钆', '钌', '钋']
钑: ['钹']
钒: ['釩', '钬', '釠']
钓: ['犳', '铂', '灼', '钔']
钔: ['钥', '铂', '钓', '铝']
钕: ['钬', '钍', '钴']
钘: ['豣', '鈃']
钚: ['讦', '纡']
钜: ['钶']
钝: ['铃']
钞: ['锉', '钱', '钡']
钡: ['锉', '锶', '钱', '镠', '钞', '钣']
钢: ['锅', '镅', '钏', '纲']
钣: ['钡']
钤: ['铨']
钥: ['钼', '铭', '钔', '铝']
钦: ['钬', '弞']
钪: ['秔']
钫: ['祊', '妨', '坊']
钬: ['钦', '钕', '钒']
钮: ['扭', '吜']
钯: ['铓']
钰: ['钐', '钍', '钉', '铦', '釭', '钌']
钱: ['锉', '钡', '锚', '钞']
钳: ['绀']
钴: ['钐', '钍', '跕', '钕', '鉒', '铦', '狜', '铪']
钶: ['钜']
钷: ['铯']
钹: ['鈸', '钑']
钻: ['怗', '钇', '詀']
钼: ['钥', '铝']
钾: ['狎', '钿']
钿: ['钾']
铀: ['蚰']
铁: ['铱', '铗']
铂: ['鉑', '铭', '钓', '钔']
铃: ['钝']
铄: ['铩', '锸']
铈: ['钍']
铊: ['炨']
铏: ['鍘']
铓: ['钯']
铗: ['铥', '铱', '铁', '祑']
铘: ['镠']
铙: ['镌', '挠', '锚', '铫']
铚: ['臸']
铜: ['锔', '锅', '挏']
铝: ['钼', '钥', '钔']
铟: ['锅', '锠']
铠: ['锫']
铥: ['铩', '铗', '钣']
铦: ['钰', '钍', '姡', '钴']
铨: ['钤']
铩: ['铄']
铪: ['炲', '恰', '钴', '烚', '佮']
铫: ['铙']
铬: ['锆']
铭: ['钥', '铂']
铯: ['绝', '钷']
铰: ['较']
铱: ['铳', '铁', '铗']
铳: ['铱']
铵: ['镔']
银: ['裉']
铷: ['枷']
铸: ['祷']
铺: ['秿', '销', '辅']
铻: ['锯', '晤', '捃', '锆']
铼: ['锿', '锭']
链: ['裢', '锭']
销: ['銷', '睄', '铺']
锁: ['镁', '镀']
锂: ['狸', '锱']
锃: ['埕']
锄: ['锏']
锅: ['钢', '铟', '铜']
锆: ['锝', '铬', '锯', '铻', '诰']
锇: ['镮', '镄']
锉: ['钱', '钡', '锚', '锼', '钞']
锊: ['蛶']
锍: ['镲', '镣']
锎: ['镅']
锏: ['锄']
锓: ['镉']
锔: ['铜']
锕: ['錒']
锖: ['靖', '腈', '鲭', '请']
错: ['措', '猎']
锚: ['锉', '钱', '铙', '錨']
锜: ['锵', '猗']
锝: ['锆']
锞: ['镙', '捰', '镊']
锠: ['铟']
锢: ['祻']
锤: ['镴', '锸']
锥: ['猚']
锧: ['踬']
锫: ['铠']
锬: ['谈']
锭: ['铼', '婝', '链', '绽']
锯: ['铻', '裾', '锆']
锱: ['锂', '缁', '錙']
锲: ['揳']
锵: ['锜']
锶: ['钡', '锼']
锷: ['鍔']
锸: ['铄', '锤']
锹: ['揪']
锼: ['锉', '锶']
锽: ['餭', '窖']
锾: ['缓', '谖']
锿: ['铼', '镓']
镀: ['锁', '踱']
镁: ['鎂', '锁']
镂: ['缕']
镃: ['镒']
镄: ['镮', '锇']
镅: ['钢', '锎']
镆: ['摸', '镬']
镈: ['膊']
镉: ['锓']
镊: ['锞']
镋: ['镜', '镫']
镌: ['铙', '镱']
镎: ['鎿']
镏: ['塯', '蹓']
镐: ['缟', '禞', '镜', '镩', '熇', '塙']
镒: ['鎰', '搤', '镃']
镓: ['镔', '锿']
镔: ['缤', '铵']
镘: ['镴', '鑀']
镙: ['摞', '缧', '鏍', '锞']
镜: ['镋', '襓', '镩', '镐']
镞: ['镟']
镟: ['镞']
镠: ['豂', '蹘', '钡', '铘']
镡: ['瞫', '贉', '憛', '墰', '谭', '曋']
镣: ['镲', '锍', '撩']
镦: ['撴']
镨: ['铸']
镩: ['镜', '镐']
镪: ['鏹', '摾']
镫: ['镋', '撜']
镬: ['镆']
镮: ['镄', '擐', '锇']
镯: ['蠋']
镱: ['镌']
镲: ['镣', '锍', '擦']
镴: ['獵', '镘', '擸', '鑞', '锤']
镶: ['禳']
長: ['旻']
镾: ['獼']
长: ['卄']
閁: ['冈']
閅: ['閬', '關']
閆: ['閘', '閫']
閇: ['閐', '閈']
閈: ['閇', '閐', '閻']
閉: ['闈', '閱']
閊: ['間']
開: ['閏', '閲', '閔', '閗']
閌: ['閠', '闀', '閏', '閲', '閼']
閍: ['閕', '焛', '閞']
閎: ['闠', '闃', '闕', '閚', '閑', '閯', '閾']
閏: ['閠', '閌', '開', '閲', '閔']
閐: ['閇', '閈', '閭', '闁', '閭', '閵', '閽', '閻', '阈']
閑: ['闕', '閚', '閯', '閎']
閒: ['閧', '閴', '関']
間: ['閊']
閔: ['開', '閏', '閲']
閕: ['闡', '焛', '閍', '閞', '誾', '閹', '闇']
閖: ['闥', '闢', '閨']
閗: ['閝', '開']
閘: ['閆', '閴', '鬦', '閣', '闆']
閙: ['閶']
閚: ['闃', '闕', '閑', '閯', '閎']
閛: ['閸', '閤', '焛', '閞', '誾', '閱', '閩', '闇']
閝: ['閲', '閗']
閞: ['闡', '閸', '閕', '焛', '閍', '誾', '閱', '閩', '闇']
閠: ['閌', '閏', '關', '閼']
閡: ['闠', '闓', '闃', '閺', '闘', '闝', '閳', '閾']
関: ['閒', '閱', '閣']
閣: ['閧', '関', '闆', '閘', '閫']
閤: ['閛', '閸', '誾', '閱', '閩', '闇']
閥: ['閼']
閧: ['閒', '閣']
閨: ['闔', '闛', '闥', '閖', '闢']
閩: ['閛', '闡', '閸', '焛', '闞', '閞', '誾', '閱', '閤']
閪: ['闞', '鬫', '闈']
閫: ['閆', '闣', '関', '闆', '閣']
閬: ['闃', '聞', '闍', '闕', '閅', '閯', '關', '闐', '閼']
閭: ['閐', '閭', '闁', '閵', '圄', '閻']
閮: ['闟', '闊', '闧', '闒', '闥', '闋']
閯: ['闃', '闍', '闕', '閚', '閑', '閬', '閎']
閱: ['閛', '閸', '焛', '関', '閞', '閉', '誾', '閩', '閤']
閲: ['閝', '閌', '開', '閏', '閔']
閳: ['闠', '闓', '闃', '闘', '闝', '閡']
閴: ['阛', '閒', '閽', '阓', '鬦', '閘']
閵: ['閐', '閭', '闁', '閭', '閻']
閶: ['閙']
閸: ['閛', '闡', '阘', '閤', '閞', '誾', '閱', '鬧', '閩']
閹: ['闖', '闡', '閕', '闙', '誾', '闇', '闄']
閺: ['闃', '閿', '閡', '闅']
閻: ['閐', '閈', '閭', '闁', '閭', '閵', '閽', '園']
閼: ['閠', '聞', '閌', '閬', '關', '閥', '闐']
閽: ['閐', '閴', '閻']
閾: ['闠', '闃', '闕', '闝', '閚', '閡', '閎']
閿: ['闃', '閺', '闅']
闀: ['閌']
闁: ['閐', '閭', '閭', '閵', '閻']
闃: ['闠', '闕', '閚', '閿', '閡', '閯', '闅', '閎', '閳', '閾']
闄: ['闖', '闎', '鬨', '闡', '闚', '闙', '闋', '圜', '閹']
闅: ['闃', '闎', '閺', '閿']
闆: ['関', '閣', '閫', '閘']
闇: ['閛', '闡', '閕', '圈', '閤', '焛', '閞', '誾', '閹', '鬧', '閩']
闈: ['闡', '闣', '闞', '閉']
闉: ['闤', '闌', '闦']
闊: ['闖', '闚', '閮', '闥', '鬩']
闋: ['闎', '閮', '闄']
闌: ['闤', '闉', '闦']
闍: ['聞', '閬', '閯', '關', '闐', '閼']
闎: ['闋', '闅', '闄']
闐: ['聞', '闍', '閬', '關', '閼']
闑: ['闓', '闟', '闘', '闧', '闒', '闦']
闒: ['闔', '闤', '闟', '闖', '闚', '閮', '闧', '闑']
闓: ['闠', '闘', '闝', '闧', '閡', '闑', '閳']
闔: ['闒', '闥', '閖', '闢', '鬬', '麈', '鬪', '閨']
闕: ['闃', '閚', '閑', '閯', '閎', '閾']
闖: ['鬨', '闚', '闊', '闒', '闙', '閹', '闄']
闘: ['闠', '闓', '闝', '閡', '閳']
闙: ['闖', '闡', '閕', '閍', '閹', '闄']
闚: ['闖', '闊', '闒', '闥', '鬩', '闄']
闛: ['閨']
關: ['閠', '聞', '闍', '閅', '閬', '闐', '閼']
闝: ['闠', '闓', '闃', '闘', '閡', '閳', '閾']
闞: ['閪', '闣', '鬫', '闈', '閩']
闟: ['閮', '闒', '闥', '闑', '闦']
闠: ['闓', '闃', '闝', '閡', '閎', '閳', '閾']
闡: ['閸', '閕', '焛', '闙', '闈', '閞', '誾', '閹', '閱', '閩', '闇', '闄']
闢: ['闔', '闥', '閖', '閨']
闣: ['國', '圕', '闞', '鬫', '闈', '閫']
闤: ['闉', '闧', '闒', '闌', '闦']
闥: ['闔', '闟', '闚', '闊', '閮', '閖', '闢', '閨']
闦: ['闤', '闟', '閟', '闉', '闧', '闌', '闑']
闧: ['闓', '閮', '闒', '闑', '闦']
门: ['冂', '邝', '闵', '口', '闩', '囗', '闪']
闩: ['冂', '闵', '臼', '囗', '闪', '门']
闪: ['闩']
闫: ['闰', '间']
闭: ['闲']
问: ['闵']
闯: ['闻']
闰: ['闫', '间']
闱: ['阒', '闺']
闲: ['闭']
闳: ['阙', '阎', '阏', '闽', '阕', '阀', '闼', '闹']
间: ['闰', '闫']
闵: ['问']
闶: ['阂', '阅']
闷: ['阅']
闸: ['阙', '阋', '阕', '阀', '闹']
闹: ['闳', '闸', '阙', '阏', '闽', '阀']
闺: ['阒', '闱']
闻: ['闾', '闯', '阅']
闼: ['闳', '阎', '阋', '阚', '阀']
闽: ['闳', '阙', '阎', '阏', '阋', '阀', '闹']
闾: ['阂', '闻']
闿: ['闳', '阎', '闼']
阀: ['闳', '闸', '阙', '阎', '阏', '闽', '阋', '阕', '闼', '闹']
阁: ['阄', '阆', '阍']
阂: ['闶', '闾']
阃: ['訚', '阖', '阇']
阄: ['阁', '阍']
阅: ['闶', '闻', '闷']
阆: ['阏', '阁', '阍', '阌']
阇: ['阃', '阉']
阈: ['閐']
阉: ['阃', '阇']
阊: ['阒', '闺', '訚', '闼']
阋: ['阙', '阎', '阏', '闽', '阕', '阀']
阌: ['阆', '阕', '阍']
阍: ['阄', '阆', '阁', '阌']
阎: ['闳', '阙', '阏', '闽', '阋', '阚', '阕', '阀', '闼', '闿']
阏: ['闳', '阙', '阎', '阆', '闽', '阋', '阕', '阀', '闹']
阐: ['阒']
阑: ['阛', '圉']
阒: ['阐', '阊', '闱', '闺']
阓: ['阛', '閴']
阕: ['闳', '闸', '阙', '阎', '阏', '阋', '阀']
阖: ['訚', '阃', '図']
阗: ['閴', '圆', '園']
阘: ['閸', '鬧']
阙: ['闳', '闸', '阎', '阏', '闽', '阋', '阕', '阀', '闹']
阚: ['阎', '闼']
阛: ['阑', '閴', '阓', '鬦']
阜: ['稟', '草', '亨', '皐', '車', '卓', '皇', '車']
阝: ['卪']
阡: ['紝', '旰']
阣: ['阼', '讫']
阤: ['扡']
阪: ['眅', '皈']
阫: ['呸']
阬: ['陀', '貥']
阮: ['阮', '阶', '盶']
阯: ['陉']
阰: ['批', '佌']
防: ['紡', '访']
阶: ['阮', '阮']
阹: ['陈', '陔']
阼: ['阣', '沣']
阽: ['貼']
陀: ['阬']
陂: ['陕']
陈: ['胨', '阹', '冻']
陉: ['羟', '阯', '径']
陊: ['陟']
陌: ['眄']
降: ['降']
陎: ['昧', '跊', '眜']
陏: ['贿']
陒: ['蛫', '脆']
陓: ['挎']
陔: ['阹', '昣']
陕: ['陜', '挟', '陂']
陗: ['绡']
陙: ['赈', '娠', '賑']
陚: ['賦', '赋']
陜: ['峽', '陕', '陝', '胦']
陝: ['陜']
陟: ['陊']
院: ['脘']
陦: ['賰', '陪', '诪']
陧: ['隉', '裡']
险: ['眕']
陪: ['陦', '賠']
陫: ['诽']
陬: ['棷']
陭: ['随']
陮: ['脽']
陯: ['腀', '睔']
陳: ['眱', '腖']
陴: ['脾']
陵: ['朡', '陵', '陸', '陸']
陷: ['陹']
陸: ['陵', '陵', '陸']
陽: ['隔']
隁: ['瞘']
隃: ['踰']
隆: ['隆']
隈: ['隟', '喂']
隉: ['陧', '湼', '涅']
隋: ['隮', '隫']
隌: ['唶']
隍: ['蝗']
隑: ['榿', '滍']
隒: ['膁', '賺', '缣']
隔: ['嗝', '陽', '隬']
隖: ['隝', '鎢']
隗: ['騩', '磈']
障: ['皡', '傽']
隝: ['鵙', '隖']
隞: ['嫩', '瞮']
隟: ['隈']
隠: ['隱']
隢: ['膮', '皢']
隣: ['隣', '膦']
隥: ['噔', '膯']
隫: ['隋', '僨', '槓']
隬: ['隔']
隭: ['隯', '糯', '蠕']
隮: ['隋', '懠', '唷']
隯: ['懤', '隭']
隱: ['隠']
隴: ['巄', '櫳']
隶: ['粜', '泉', '淾']
隸: ['隸']
隻: ['篗']
隿: ['雂']
雁: ['䧹']
雂: ['隿']
雄: ['雊']
集: ['梥']
雇: ['扉']
雈: ['萑']
雊: ['雛', '雄']
雐: ['虘', '虐']
雘: ['臒']
雙: ['﨎']
雚: ['萫', '藋']
雛: ['雊']
雜: ['離']
雞: ['雡']
雡: ['雊', '雞']
難: ['艱']
雧: ['薰', '曇', '纍']
雪: ['雷', '雷']
雫: ['雯']
雬: ['朵']
雯: ['雫']
雲: ['零', '書']
零: ['雲']
雷: ['雷', '齏', '罥']
雹: ['瞿']
電: ['氱']
雽: ['早', '伞', '學']
雿: ['霔']
需: ['霝']
霅: ['霗', '誓']
霆: ['霪', '趸']
霉: ['霮']
霋: ['曇', '窶']
霎: ['孁', '崣']
霒: ['黅']
霓: ['筧']
霔: ['雿']
霗: ['霅', '霶']
霙: ['龑', '罺', '熹', '嚞']
霛: ['霞']
霝: ['需']
霞: ['霛', '霢']
霢: ['霞']
霣: ['寊']
霪: ['畵', '霆']
霮: ['霉']
露: ['露']
霳: ['靁', '霽']
霴: ['靉']
霶: ['霗']
霻: ['寷', '籉']
霽: ['靁']
靁: ['靍', '霽', '霳']
靂: ['霺']
靈: ['寷', '靈']
靉: ['霴']
靊: ['亶', '衋']
靌: ['靀', '靎']
靍: ['靁']
靎: ['靌']
靐: ['灥', '盫', '籯']
青: ['腎']
靕: ['賾']
靖: ['腈', '锖', '鲭', '靖']
靚: ['覯']
非: ['韭']
靥: ['廧']
靧: ['醲']
革: ['亊', '孳', '苯', '聿', '荜']
靫: ['鞖']
靰: ['軏']
靳: ['斩', '斬']
靹: ['軸']
靻: ['靼']
靼: ['靻']
鞀: ['齠', '軺', '駋']
鞁: ['鞅', '啵']
鞃: ['鞉']
鞅: ['鞁']
鞉: ['鞃']
鞋: ['鞐']
鞏: ['羣']
鞐: ['鞋']
鞖: ['靫']
鞗: ['愇']
鞘: ['矟', '鞜']
鞛: ['鞳']
鞜: ['鞘']
鞝: ['琑']
鞣: ['騥']
鞤: ['鞶']
鞨: ['輵']
鞪: ['璽']
鞫: ['輷']
鞰: ['蝹', '韁']
鞳: ['鞛']
鞴: ['犕']
鞶: ['鞷', '鞤']
鞷: ['鞶']
鞻: ['靾']
韁: ['鞰']
韄: ['蠖']
韆: ['轤']
韉: ['韊']
韊: ['韉']
韋: ['輂', '章', '臬']
韐: ['粭', '祫']
韗: ['韣']
韝: ['韥']
韟: ['韗']
韡: ['鏵']
韢: ['韥']
韣: ['韗']
韥: ['韢']
韯: ['載']
韲: ['虀']
韶: ['貂', '鉊']
頀: ['鑊']
頁: ['賷']
頂: ['須', '預']
頃: ['暊']
頄: ['頎']
順: ['頮']
須: ['頂']
頋: ['顂', '顏']
頍: ['颏', '頹', '頞']
頎: ['顁', '頏', '頄']
頏: ['頩', '頎']
預: ['頭', '頂']
頑: ['領', '頼', '頩']
頒: ['頗', '頫', '颁']
頓: ['顖']
頖: ['顃']
頗: ['頒', '頼', '顃']
領: ['頑', '頜', '蝢', '頩', '领']
頛: ['穎']
頜: ['領', '蝢', '頩']
頞: ['頍', '颏', '頦']
頟: ['額']
頣: ['頤', '頧']
頤: ['頣']
頦: ['颏', '頧', '頞']
頧: ['頣', '頦']
頩: ['頑', '領', '頏', '頜']
頪: ['粯', '粳']
頫: ['頒']
頬: ['頰']
頭: ['顽', '預']
頮: ['頯', '顦', '順']
頯: ['頮', '顦']
頰: ['領', '頬']
頱: ['顎']
頲: ['颋']
頴: ['類', '潁', '類', '颕', '颍']
頶: ['頷']
頷: ['頶']
頸: ['顗']
頹: ['頍', '頺']
頺: ['頹']
頼: ['頑', '頗']
頽: ['頝', '颓', '顝']
顁: ['頎']
顂: ['頋']
顃: ['頗', '覢']
顄: ['顳']
顅: ['顧']
顈: ['穎']
額: ['頟']
顎: ['頱']
顏: ['頋']
顒: ['颙']
顓: ['颛']
顔: ['顖', '颇']
顕: ['顗']
顖: ['顧', '頓', '颇', '顔']
願: ['顯']
顙: ['顟']
顚: ['顬']
顝: ['頽']
類: ['類', '颏', '頴']
顟: ['顙']
顠: ['顴', '顲']
顣: ['瀬']
顥: ['颢']
顦: ['頮']
顧: ['顖', '顅']
顩: ['頷']
顬: ['顚', '颥']
顯: ['顴', '願']
顰: ['藫']
顱: ['龥']
顲: ['顈', '顠']
顳: ['顄']
顴: ['颧', '觀', '顯']
页: ['豆']
顶: ['颎']
顸: ['顾']
项: ['項']
顺: ['频']
顼: ['琐', '瑣', '琨']
顽: ['颀', '頭']
顾: ['颓', '顸', '颇', '颥']
颀: ['顽']
颁: ['頒']
颃: ['颌']
领: ['領']
颇: ['顾', '顖', '顔']
颋: ['頲']
颌: ['颃']
颍: ['颕', '頴']
颎: ['熲', '顶']
颏: ['類', '頍', '類', '颔', '颠', '頦', '頞']
颐: ['颎']
颒: ['颔', '颜']
颓: ['顾', '頽']
颔: ['颒', '颏']
颕: ['潁', '颍', '頴']
颖: ['颗', '颜', '穎']
颗: ['颖', '颤']
颙: ['顒']
颛: ['顓']
颜: ['颒', '颖']
颠: ['颢']
颢: ['顥', '颠']
颤: ['颧', '颗']
颥: ['顾', '顬']
颧: ['顴', '颤']
颩: ['颳', '颶', '颭']
颭: ['颳', '颵', '颸', '颩']
颮: ['颺', '颵', '颸', '颴']
颯: ['猦']
颰: ['颷', '飇']
颳: ['飂', '颩', '颶', '颭']
颴: ['颵', '飈', '颮', '飅']
颵: ['颺', '飈', '颮', '颹', '颸', '飀', '飅']
颶: ['颺', '颳', '飂', '颸', '颩', '颾']
颷: ['飈', '颹', '颼', '颰', '飃', '飇']
颸: ['颺', '飂', '颵', '颮', '颶', '颭']
颹: ['飈', '颵', '颷', '飅']
颺: ['飂', '颵', '颮', '颸', '颶', '飅']
颼: ['飃', '颷']
颾: ['飂', '颶']
颿: ['騛', '騾', '騄']
飀: ['飂', '颵', '飅']
飂: ['颺', '颳', '颸', '飀', '颶', '颾']
飃: ['颼', '颷', '飅']
飅: ['颺', '颵', '颮', '颹', '飃', '飀', '颴']
飇: ['飈', '颰', '颷']
飈: ['颵', '颹', '颷', '颴', '飇']
飑: ['飚']
飔: ['飚']
飕: ['飗']
飗: ['飕']
飚: ['飔', '飑']
飡: ['凎']
飢: ['釠']
飥: ['魹', '飪', '飦', '魠']
飦: ['飪', '飥', '釺']
飧: ['飨']
飨: ['飧']
飩: ['飾']
飪: ['訌', '飥', '妊', '鈓', '釺', '飦', '魠']
飫: ['鈓']
飬: ['鸒']
飮: ['飲', '欽']
飲: ['欽', '飮']
飳: ['鉒']
飴: ['飽', '齝', '餝']
飶: ['鮅']
飷: ['爼']
飹: ['鉚']
飽: ['骲', '飴']
飾: ['飩']
飿: ['鈯', '館']
餂: ['銛']
餃: ['餀', '餏']
餅: ['軿', '鉼', '鮵', '鮩', '餠', '骿']
餆: ['餞', '鮡', '脁']
餇: ['姛']
餈: ['餥']
養: ['羛']
餌: ['鉺']
餍: ['臒']
餎: ['鮥']
餏: ['銥', '餃']
餑: ['賥']
餒: ['餧']
餓: ['餿']
餔: ['舖']
餕: ['鮻']
餖: ['鋀']
餗: ['餜', '銇', '娕']
餙: ['餲']
餚: ['餫']
餜: ['馃', '餗']
餝: ['飴']
餞: ['饅', '錢', '餆']
餟: ['蝃']
餠: ['餅', '輧', '骿']
餡: ['錎']
餢: ['錇']
餥: ['餈']
餧: ['餒', '餿']
館: ['飿']
餩: ['饓']
餪: ['饌']
餫: ['蟬', '饆', '餚', '緷', '皹']
餭: ['锽', '蝕', '餿']
餯: ['蝝']
餱: ['緱']
餲: ['竭', '蝎', '餙', '齃', '餶']
餴: ['錛']
餵: ['饂']
餶: ['餲']
餹: ['饝', '鎕']
餺: ['餹', '鎛', '鱒']
餽: ['媿']
餾: ['蹓']
餿: ['餧', '餭', '餓']
饂: ['饇', '錫', '餵']
饅: ['餞', '鳗']
饆: ['餫']
饇: ['饂']
饈: ['鱃', '馐']
饋: ['穨', '饙', '饐', '嫧']
饌: ['餪']
饍: ['嫸']
饎: ['饙']
饐: ['嬄', '饋']
饑: ['鐖']
饒: ['饙', '驍', '鐃']
饓: ['餩']
饖: ['鐬', '鱇', '鱥']
饙: ['饎', '饒', '鱝', '鐼', '饋']
饛: ['艨']
饜: ['贗']
饝: ['餹']
饠: ['饢', '鑼']
饢: ['饠']
饣: ['钅', '忄']
饤: ['玎', '汀']
饦: ['纴']
饩: ['汽']
饫: ['饮']
饬: ['怍']
饯: ['线']
饱: ['饹']
饲: ['词']
饳: ['训', '汌']
饴: ['饸', '恄', '洽']
饵: ['栮', '挕']
饶: ['浇']
饷: ['姠']
饸: ['饴', '洽']
饹: ['饱']
饺: ['悏']
饽: ['脖']
饾: ['迌', '浢']
馃: ['餜']
馄: ['绲']
馇: ['饶', '揸']
馉: ['懁']
馐: ['饈']
馒: ['谩']
首: ['酋']
馗: ['縇']
馥: ['馩']
馩: ['馥']
馫: ['壽']
馭: ['駅']
馱: ['駀', '駖', '馳', '馻']
馳: ['駖', '馱', '馻']
馴: ['駟']
馶: ['駃', '豉', '駁', '駸']
馷: ['騂']
馸: ['駈']
馺: ['騄', '駿', '騱']
馻: ['駀', '駖', '駩', '駾', '馳', '駇', '馱']
馾: ['駐']
駀: ['馻']
駁: ['馶', '駃']
駃: ['趺', '駁', '馶']
駄: ['駫', '駣', '駃']
駅: ['騈', '馭']
駇: ['馻']
駈: ['馸']
駊: ['皸']
駏: ['駬', '跙', '壾']
駐: ['馾']
駔: ['駏', '豠']
駖: ['驂', '駗', '駾', '騇', '馳', '馻', '聆']
駗: ['駖']
駚: ['騋', '駭', '駮', '駯']
駟: ['馴']
駡: ['罵']
駣: ['駫', '駪', '駄']
駩: ['騇', '馻']
駪: ['駫', '駣', '銑', '驥']
駫: ['駣', '駪', '騦', '騐', '驥', '駄']
駬: ['駏']
駭: ['駮', '駯', '駚', '駿', '騱']
駮: ['騋', '駭', '駚', '駿']
駯: ['駭', '騅', '跊', '駚']
駰: ['裀', '秵']
駱: ['騈', '駱', '路', '酪', '酪', '路']
駴: ['驏', '驟', '驥']
駶: ['騧']
駷: ['騡', '騍']
駸: ['馶']
駹: ['騥', '驠']
駼: ['騋', '騾']
駾: ['駖']
駿: ['駭', '駮', '馺']
騀: ['驥']
騁: ['聘']
騂: ['馷']
騃: ['騤']
騄: ['騾', '馺', '醁', '颿', '睩']
騅: ['駯', '騴']
騇: ['駖', '駩']
騈: ['駱', '駱', '駅']
騋: ['駼', '駮', '駚']
騌: ['騙']
騍: ['騡', '駷', '騥', '騜']
騎: ['驊', '齮']
騏: ['踑']
騐: ['駫', '踗', '騘']
騒: ['騷']
騕: ['騦']
騖: ['氂']
騘: ['騐']
騙: ['騌']
騛: ['騾', '颿']
騜: ['騍']
騞: ['騯']
騟: ['貐']
騡: ['駷', '騍']
騢: ['貑']
騤: ['騅', '騃']
騥: ['駹', '騍']
騦: ['駫', '騕']
騧: ['駶']
騩: ['隗']
騪: ['驂', '驝']
騬: ['腂', '驟']
騮: ['騷']
騰: ['鰧']
騱: ['駭', '貕', '馺']
騲: ['驊']
騴: ['騅']
騵: ['豲', '驗']
騷: ['驟', '騒', '騮']
騺: ['驁']
騻: ['騯', '赎', '驎']
騼: ['蹗']
騾: ['驋', '騛', '騄', '颿']
驁: ['鸗', '騺']
驂: ['駖', '騪']
驃: ['鳔']
驅: ['驉']
驈: ['璚']
驉: ['驅']
驊: ['騲']
驋: ['騾']
驌: ['驣']
驍: ['饒', '髐', '曉']
驎: ['騻', '暽']
驏: ['駴', '驟', '驥']
驒: ['驊', '嚲', '騲']
驓: ['騶']
驕: ['蹻', '鐈']
驗: ['礆']
驘: ['赢', '贏', '鸁', '嬴', '蠃', '羸']
驜: ['驝']
驝: ['驜', '騪']
驟: ['駴', '騷', '驏', '騬', '驥']
驠: ['駹']
驣: ['驌']
驤: ['膿']
驥: ['駴', '駫', '驟', '騀', '駪']
驨: ['瓗']
驩: ['礶']
驪: ['釃']
驮: ['舦']
驯: ['驷', '驹']
驵: ['耼']
驶: ['骇']
驷: ['驯']
驹: ['驯']
驻: ['跓']
骁: ['硗']
骇: ['驶', '孩']
骎: ['骧']
骏: ['骐']
骐: ['骏']
骒: ['骡']
骓: ['琟', '骙']
骔: ['誴']
骙: ['骓']
骜: ['鹜']
骡: ['骒', '骤']
骣: ['骥']
骤: ['骡']
骥: ['骧', '骣']
骧: ['骎', '骥']
骨: ['脅']
骭: ['趶']
骯: ['貥']
骰: ['骽', '殴']
骲: ['飽']
骳: ['骸']
骸: ['骳']
骽: ['骰', '鋖', '髏']
骿: ['胼', '餠', '餅']
髀: ['睥']
髂: ['髖']
髆: ['髈']
髈: ['髆']
髏: ['骽', '貗']
髐: ['驍', '髖']
髖: ['髐', '髂']
髚: ['鴥']
髩: ['髯']
髪: ['髮']
髫: ['髷']
髭: ['鬁']
髮: ['髪']
髯: ['髩', '寗']
髲: ['髷']
髶: ['鬀', '鬓']
髷: ['髫', '髲']
髸: ['鬂']
髺: ['罊', '瞿', '髻', '鬀']
髻: ['髺', '謈']
髼: ['鬇']
髽: ['桽']
鬀: ['嚚', '髺', '鬈', '髶']
鬁: ['髭', '鬅']
鬂: ['髸', '龔', '龑']
鬄: ['鬠']
鬇: ['髼']
鬈: ['鬀']
鬌: ['鬐', '鬙']
鬎: ['鬏']
鬏: ['鬎']
鬒: ['贒', '贀']
鬓: ['髶']
鬕: ['鬘', '鬢']
鬘: ['鬟', '鬕']
鬙: ['鬞', '諐', '鬌']
鬞: ['鬙']
鬟: ['鬘']
鬠: ['鬄']
鬢: ['鬕']
鬤: ['鬟', '囊']
鬦: ['阛', '閴', '閘']
鬧: ['鬨', '闡', '閸', '阘', '誾', '閩', '闇']
鬨: ['闖', '鬩', '鬧', '闄']
鬩: ['闖', '鬨', '闚', '闊', '鬪']
鬪: ['闔', '闥', '鬩', '閖', '鬬']
鬫: ['閪', '闣', '闞']
鬬: ['闔', '鬪']
鬮: ['圝']
鬴: ['豧']
鬵: ['鶩']
鬹: ['鷲']
鬻: ['翯']
鬽: ['尅']
鬾: ['魃']
魃: ['魅', '鬾']
魅: ['鲑', '魃']
魆: ['魈', '魅', '魊']
魇: ['厔']
魈: ['魆']
魉: ['魍']
魊: ['魆']
魍: ['魉']
魒: ['魓']
魓: ['魒']
魔: ['廣']
魘: ['嬮']
魛: ['糿', '紉']
魜: ['魪', '魰', '鱿']
魞: ['魼', '鮗', '穌']
魟: ['鈺', '釭']
魠: ['魹', '飪', '飥', '鮖']
魡: ['約', '鮈']
魢: ['鮔', '鮅', '鮎']
魥: ['鮾', '觙', '鯎']
魦: ['觘', '魬', '魿', '鮐', '鮯', '鮗']
魧: ['鯌', '魫', '魴', '鮀']
魨: ['鮚']
魪: ['魜', '畍']
魫: ['鯢', '魧', '鮕']
魬: ['魦', '觝', '魮']
魮: ['魬', '魥', '鮯', '鮲']
魯: ['魯']
魰: ['鮌', '魜', '鮫']
魱: ['鮔', '魺']
魳: ['魣']
魴: ['舫', '魧']
魵: ['紛']
魶: ['鲉']
魷: ['觨']
魹: ['飥', '鮎']
魺: ['魱', '鮔', '鮅']
魻: ['鯝']
魼: ['鮌', '魞', '鯄', '鯎', '蚿']
魽: ['鮶', '鮒']
魾: ['鉟']
魿: ['魦', '铃']
鮀: ['鮚', '舵', '魫', '魧', '鮕', '魨']
鮂: ['鮙', '鈿', '鮉', '絪']
鮃: ['軯']
鮄: ['鱎', '紼', '鮡']
鮅: ['飶', '魺']
鮈: ['魡', '鯏', '絇']
鮉: ['鮂']
鮋: ['舳']
鮌: ['鯇', '魼', '魰', '鮷', '鮫', '鱰']
鮍: ['鮟']
鮎: ['魢', '魹', '點']
鮐: ['齝', '魦', '鮯']
鮒: ['魽']
鮔: ['魱', '鮞']
鮕: ['鯌', '魫', '岵', '鮀']
鮖: ['魠']
鮗: ['魞', '魦']
鮘: ['鮴', '鮲']
鮙: ['鮂']
鮚: ['鮶', '鯃', '魨', '鮀']
鮛: ['鯄']
鮞: ['鮔']
鮟: ['鮍']
鮠: ['觤', '鰞']
鮡: ['鱎', '鰦', '鮄', '餆']
鮢: ['鮽', '鰁', '鯠']
鮥: ['餎']
鮦: ['餇', '鯧', '鯝']
鮧: ['銕']
鮩: ['餅']
鮫: ['鮌', '鯇', '魰']
鮬: ['鯙', '姱', '鰟', '骻']
鮭: ['觟', '鲑']
鮮: ['鲜']
鮯: ['齝', '魦', '鮐', '魮']
鮲: ['鮘']
鮳: ['鮹']
鮴: ['鰍', '鮘']
鮵: ['軿', '鯢', '餅']
鮶: ['鮚', '鯃']
鮷: ['鮌', '鯣', '鯑']
鮹: ['鮳', '鯕']
鮻: ['鰒', '餕']
鮼: ['鱘', '鰮', '鯞']
鮽: ['鮢', '餘', '鰖', '鰾']
鮾: ['鯘', '魥']
鮿: ['鰕']
鯀: ['鯷', '鰠', '鯮', '鯑', '鰥']
鯃: ['鮚', '鮶', '鰙', '龉']
鯄: ['鮛', '魼', '觩', '鯎']
鯅: ['脠', '鰸']
鯆: ['鯖']
鯇: ['鱚', '鮌', '鯼', '鰄', '鲩', '鮫']
鯉: ['鯹']
鯎: ['魥', '魼', '鯡', '鰔', '鯄']
鯏: ['鯽', '鰯', '鯯', '鰂', '鯻']
鯑: ['鰃', '鮷', '鯀']
鯓: ['鰚']
鯔: ['鯷', '鰠', '鯺', '鰸']
鯖: ['鯆', '鱄']
鯗: ['蔒', '薫']
鯘: ['鮾', '鰩']
鯙: ['鱤', '鮬']
鯚: ['鰐']
鯝: ['鯧', '魻', '鮦']
鯞: ['鮼', '鱞', '鰮', '鰩']
鯟: ['鰁', '鰊']
鯠: ['鮢', '鯐']
鯡: ['鰔', '鯎']
鯢: ['鮵', '鰘', '觬']
鯣: ['鰛', '鰮', '鱨', '鮷']
鯥: ['鰟']
鯧: ['鯝', '鮦']
鯨: ['鯮', '鯀']
鯩: ['鮠', '鰬', '鰑']
鯪: ['鯼', '婈']
鯫: ['鰕']
鯮: ['鯨', '鰥', '鯀']
鯯: ['鯻', '鯏']
鯱: ['鰒', '鱲', '鰪', '鰝', '鱆', '鱝', '鰿', '鱙']
鯵: ['鰺', '鰿', '鯠', '鱶']
鯶: ['輝', '鰐']
鯷: ['鰠', '鰥', '鯀', '鰸']
鯸: ['鰇']
鯹: ['鰛', '鰮', '鯉']
鯺: ['帾', '鰠', '鰟', '鯔']
鯻: ['鯯', '鰂', '鯏']
鯼: ['鱕', '鯇', '鰄', '鯪', '緵']
鯽: ['鰂', '鯏']
鰀: ['鱫', '鰬']
鰁: ['鮢', '鯟', '鰊']
鰂: ['鯽', '鰯', '鯻', '鯏']
鰃: ['鱕', '鰠', '鯑', '鰸']
鰄: ['鱖', '鯼', '鯇', '贓', '鰋']
鰆: ['椿']
鰇: ['鯸', '鱫']
鰈: ['鲽']
鰉: ['鰛', '錞']
鰊: ['鯟', '鰁']
鰋: ['鱖', '鱕', '鰄', '鱷', '鰠', '鰸']
鰌: ['鯌']
鰍: ['鱖', '鯅', '鮴']
鰎: ['踺']
鰐: ['鯚', '鯶']
鰑: ['鰞', '鯩']
鰒: ['鰪', '緮', '鱆', '鰻', '鯱']
鰓: ['鰮', '鱨', '鰩']
鰔: ['鯡', '鯎']
鰕: ['縀', '鯫', '鮿']
鰖: ['鰝', '鮽', '鯍', '鱝', '鰿', '鱔']
鰘: ['鯢', '鰚']
鰚: ['鯓', '鰘']
鰛: ['鯹', '鰮', '鰠', '鰉', '鯣']
鰜: ['鎌', '縑']
鰝: ['鱆', '鎬', '鯱', '鰖']
鰞: ['鮠', '鰀', '鰑']
鰟: ['艕', '鮬', '鯥', '鯺']
鰠: ['鱖', '鰛', '鰃', '鯷', '鰋', '鱰', '鰥', '鯀', '鯔', '鰸']
鰤: ['蛳']
鰥: ['鯷', '鰠', '鯮', '鯀']
鰦: ['鱡', '鮡']
鰧: ['騰']
鰩: ['鯘', '鱞', '鰮', '鱨', '魮', '鯞', '鰓']
鰪: ['鰒', '鰻', '鯱', '鱪', '鱙']
鰬: ['鰀']
鰭: ['鷠', '鰽']
鰮: ['鮼', '鱘', '鯹', '鰛', '鱨', '鰩', '鯣', '鯞', '鰓']
鰯: ['鰂', '鯏']
鰲: ['螫']
鰴: ['微']
鰸: ['鱖', '鰛', '鯅', '鰃', '鯷', '鰠', '鰋', '鱦', '鯔']
鰺: ['鱫', '慘']
鰻: ['鰒', '鰪', '鳗', '鱫', '鱪']
鰼: ['鱛', '鳛']
鰽: ['輤', '鷠', '鏪', '鰭']
鰾: ['鮽', '鱝', '鰿', '鱶']
鰿: ['饙', '鱐', '鱝', '鯱', '鱗', '鰖', '鐼', '鱗', '鯵', '鰾', '饋', '鱶']
鱃: ['饈']
鱄: ['鯖', '縳']
鱅: ['鏞', '鱴']
鱆: ['鰒', '鰪', '鰝', '鱝', '鏱', '鯱', '鱙']
鱇: ['饖', '躿', '鱥']
鱈: ['轌', '鱗', '鰿']
鱊: ['鱎']
鱋: ['鱐', '鱶']
鱌: ['緣', '鱥']
鱍: ['鱲']
鱎: ['鮄', '鮡', '鱊']
鱏: ['罈', '禫', '橝']
鱐: ['鱋', '鰿', '鱱']
鱑: ['鱵', '鱴', '觵']
鱒: ['餺', '鱔']
鱓: ['鱚', '鱰']
鱔: ['鐥', '鱒', '鰖']
鱕: ['鯼', '鰃', '鱷', '鰋', '鱩', '鰸']
鱖: ['鰍', '鰄', '鰠', '鰋', '鰸']
鱗: ['鏻', '鱝', '鱗', '鰿', '鯠', '繗']
鱘: ['鮼', '鯹', '鰮', '鯞']
鱙: ['鰪', '鱆', '嬈', '鯱']
鱚: ['鯇', '鱓', '鰋', '鱩', '鰸']
鱛: ['鰼']
鱝: ['饙', '鱆', '羵', '鯱', '鰖', '鐼', '鱗', '鰿', '鰾', '鱶']
鱞: ['懁', '鰩', '鯞']
鱠: ['鱚', '嬒']
鱡: ['鰦']
鱢: ['鱳']
鱣: ['鱧']
鱥: ['鰷', '鐬', '饖', '鱌', '鱇']
鱦: ['鰸']
鱧: ['鱣', '鱫', '鱪']
鱨: ['鰛', '鰮', '鰩', '鰓']
鱩: ['鱚', '鱕']
鱪: ['鱧', '鳗', '鰻', '鱫']
鱫: ['鱧', '鰺', '鰻', '鰀', '鰇', '鮁', '鱪']
鱬: ['臑', '襦', '羺', '嶿']
鱭: ['鑇']
鱯: ['饚']
鱰: ['鮌', '鰠']
鱱: ['鱐']
鱲: ['蠟', '鱍']
鱳: ['躒', '鱢']
鱴: ['鱅', '鱑']
鱵: ['鱑']
鱶: ['鱝', '鱋', '鰿', '鰾']
鱷: ['鱕', '鰋', '鰸']
鱸: ['艫']
鱹: ['罐', '鑵']
鱽: ['訒', '纫', '釛']
鱾: ['釲']
鱿: ['魜', '鲩']
鲀: ['鈍', '鲒']
鲄: ['舸', '鈳']
鲅: ['鈸']
鲇: ['釔']
鲉: ['魶']
鲊: ['飵']
鲋: ['鉜', '跗']
鲏: ['皴']
鲐: ['鉿', '鈶']
鲑: ['觟', '銓', '鮭']
鲒: ['鲀']
鲓: ['鳑']
鲕: ['錏']
鲖: ['鳛', '鲴', '鲷']
鲛: ['鉸', '鋏', '较', '鉉', '鉠']
鲜: ['鮮', '觪']
鲝: ['藎']
鲠: ['錽']
鲢: ['梿']
鲣: ['铿', '鋥']
鲤: ['鳋']
鲩: ['鉣', '鱿']
鲪: ['鋙', '龉']
鲬: ['銿', '鲳']
鲭: ['靖', '腈', '鳍', '锖', '媠', '鵵']
鲮: ['緵']
鲯: ['鶀', '錤']
鲲: ['錕', '鲾']
鲳: ['鲬']
鲴: ['銦', '鲖', '鲷']
鲷: ['蜩', '鲴', '鲖']
鲸: ['鎵', '鲼']
鲻: ['缁', '鳋', '錙']
鲼: ['鲸']
鲽: ['鳈']
鲾: ['鲲', '鍢']
鳂: ['鍡', '鳏']
鳄: ['鍔']
鳅: ['鍬']
鳆: ['蝮']
鳈: ['缐', '鲽']
鳊: ['煸']
鳋: ['鲻', '鲤', '鲾']
鳍: ['螧', '鲭']
鳎: ['鎉']
鳏: ['鳂']
鳑: ['螃', '鲓', '嵭', '銙']
鳔: ['驃']
鳗: ['饅']
鳛: ['鲴', '鰼', '鲖']
鳜: ['蟩']
鳝: ['鐏', '鳡', '缮', '緖', '鳟']
鳞: ['轔']
鳟: ['鐏', '鳝', '鎨', '赙', '蹲']
鳢: ['鳣']
鳣: ['鳢']
鳥: ['鳶']
鳩: ['鳰', '鵭', '樢', '嶋', '鳺', '鳪', '鵴', '鴘', '鵤', '鳭', '鴣', '鴗', '鳼']
鳪: ['鳰', '鴘', '鳭', '鴗', '鳩']
鳫: ['鷢']
鳭: ['鳰', '鴉', '嶋', '鵨', '鳪', '鶬', '鷍', '鴟', '鳸', '鳩', '鵲']
鳰: ['樢', '嶋', '鳺', '鳪', '鵴', '鴘', '鴆', '鳭', '鴗', '鴣', '鳩']
鳱: ['鳵']
鳲: ['鳴', '鳽']
鳳: ['巖']
鳴: ['皜', '鳲', '嚝', '嘕', '﨩']
鳵: ['鳱']
鳶: ['鳥']
鳷: ['鴭', '鷆', '殦', '鵐', '鴿', '鵁', '鵢', '鵜']
鳹: ['鴇', '鴒', '鴱', '鴩', '鷱']
鳺: ['鵭', '鵤', '鴣', '鳼', '鳩']
鳻: ['鵾', '鵅', '鴻', '鴵', '鴪', '鸚', '鵛', '鴓', '鵷', '鷓', '鴖', '鵜', '鴧']
鳼: ['鵭', '鳺', '鳩']
鳽: ['鵂', '鳲']
鳾: ['鴒']
鳿: ['瞗']
鴁: ['鶧', '鴇', '鴱']
鴂: ['鵍', '鵨', '鵴', '鴘', '鴪', '鵒', '鴆', '鷍', '鴙', '鵧', '鴧']
鴅: ['鴭', '鵙', '鶻', '鶂', '鵣', '鴮', '鴿', '鶚', '鵁', '鵺', '鵃', '鶋', '鶫']
鴆: ['鵍', '鴂', '鵨', '鴵', '鶬', '鵴', '鴘', '鴪', '鵒', '鳻', '鶆', '鴙', '鴧']
鴇: ['鶧', '鴱', '鳹', '鴩', '鷱', '鴁']
鴉: ['鴡', '鴞', '鴟']
鴊: ['殦', '鵐', '鴎', '鵛', '鴖', '鵓']
鴌: ['穒']
鴎: ['鵾', '鴡', '鵖', '鷆', '殦', '鴊', '鵛', '鴖']
鴐: ['鴽']
鴑: ['穒', '鷺', '鷺', '鵹']
鴒: ['鳹', '鷱', '鳾']
鴓: ['鶅', '鵅', '鴵', '鵴', '鳻', '鵛', '鷓', '鶍']
鴔: ['鴡', '鴲']
鴖: ['鵾', '鴡', '鵖', '鷆', '殦', '鴊', '鴎', '瞗', '鷊']
鴗: ['鳰', '樢', '嶋', '鳪', '鴘', '鶜', '鷍', '鴣', '鳩']
鴘: ['鶘', '鵅', '鵍', '鵳', '鴂', '鵨', '鶕', '鳪', '鶲', '鶬', '鵴', '鵝', '鷀', '鴪', '鵒', '鶜', '鷏', '鴆', '鷍', '鴙', '鴗', '鴺', '鴟', '鴧']
鴙: ['鴂', '鵨', '鴘', '鴪', '鴆', '瞗']
鴚: ['舸', '鈳']
鴛: ['鶯', '鵉']
鴜: ['鵟']
鴝: ['鶂', '鴾', '鴳', '鷎', '鵕', '鷱', '鶴', '鵵', '鵪', '鵫', '鴫', '鶟', '鵇']
鴞: ['鴉', '鷐', '鷃', '鶪']
鴟: ['鶘', '鴡', '鴉', '鶕', '鶛', '鶬', '鴘', '鷜', '鵝', '鷀', '鵒', '鷚', '鷐', '鸛', '鷏', '鷂', '鳭', '鶵', '鴲', '鶍', '鸓', '鵲', '鷉']
鴠: ['鶪']
鴡: ['鵍', '鴉', '鵝', '鵒', '鵱', '鴎', '鴟', '瞗', '鴔', '鵢', '鴖']
鴢: ['檹', '鶂', '鷎', '鵕', '鶐', '鶊']
鴣: ['鵭', '鳺', '鵤', '鴗', '鷁', '鳩']
鴤: ['鵔']
鴦: ['鶩']
鴧: ['鵾', '鵅', '鵍', '鶉', '鴂', '鶺', '鵨', '鴻', '鴵', '鴘', '鴪', '鳻', '鴆', '鵷', '鷓', '鵧']
鴨: ['稿', '鷤']
鴩: ['鶧', '鴸', '鴇', '鷦', '鴱', '鳹', '鵵', '鴁']
鴪: ['鵅', '鵍', '鴂', '鵨', '鴵', '鴘', '鳻', '鴆', '鴙', '鵧', '鴧']
鴫: ['鶧', '鴱', '鵰', '鴝']
鴭: ['鳷', '鵙', '鵣', '鴻', '鵖', '鶙', '鵐', '鴿', '鵁', '鵢', '鵃', '鶇', '鶫']
鴮: ['鸋', '鵖', '鵺', '鵃', '鶫']
鴯: ['鷳', '鵶', '鸆', '鷁', '鶶']
鴰: ['鵘']
鴱: ['鶧', '鳹', '鴫', '鴁']
鴲: ['鵾', '鶕', '鶛', '鴟', '鴔', '鴖', '鶍', '鸓']
鴳: ['鶧', '鶂', '鵕', '鶴', '鶴', '鵵', '鵁', '鴝', '鶟', '鵺', '鵠']
鴴: ['鶺']
鴵: ['鵾', '鸀', '鵍', '鵩', '鵬', '鵝', '鴪', '鳻', '鴆', '鴓', '鵷', '鵧', '鴧']
鴶: ['鶰', '鷁']
鴸: ['鷦', '鳹', '鴩', '鵫', '鵯']
鴺: ['鵳', '鶏', '鶬', '鵴', '鴘', '鷯', '鷏', '鷷', '鵸']
鴻: ['鳷', '鴭', '鵊', '鵖', '鴿', '鵁']
鴽: ['鴐']
鴾: ['鷎', '鵕', '鴢', '鵪', '鴫', '鴝', '鵯']
鴿: ['鴭', '鴅', '鵕', '鵁', '鵃', '鵠', '鶫']
鵀: ['鸎']
鵁: ['鳷', '鴭', '鶂', '鴳', '鴅', '鵣', '鴻', '鴿', '鵃', '鶫']
鵂: ['鳽']
鵃: ['鴭', '鶂', '鴅', '鵣', '鴮', '鴿', '鵁', '鶇', '鶫']
鵄: ['鵎', '鵶', '鶡', '鶔']
鵅: ['鵍', '鶺', '鵨', '鶕', '鵴', '鴘', '鵝', '鴪', '鵒', '鳻', '鴓', '鷓', '鴲', '鴧']
鵇: ['鴸', '鴳', '鴝']
鵈: ['鶰', '鵎', '鵑']
鵉: ['齋']
鵊: ['鴭', '鵣', '鴻', '鵁', '鷑', '鷞', '鵃', '鶇', '鶫']
鵋: ['鶔']
鵍: ['鵅', '鴡', '鶎', '鶉', '鴂', '鶺', '鵨', '鶕', '鴘', '鵝', '鴪', '鵒', '鵱', '鵷', '鷓', '鴲', '鵓', '鵧', '鴧']
鵎: ['鶰', '鵈', '鵄', '鵶', '鶝', '鶢', '鶔', '鶪']
鵏: ['鶣', '鷀', '鷐', '鷒', '鶆', '鸓']
鵐: ['鳷', '鴭', '鵙', '鵖', '鷆', '殦', '鴊', '翵', '鶋']
鵑: ['鵈']
鵒: ['鵅', '鴡', '鵍', '鴂', '鵨', '鶬', '鵴', '鴘', '鴟', '鵲']
鵓: ['鶉', '鴊', '鵱', '鵢']
鵔: ['鴤']
鵕: ['鶧', '鶂', '鴳', '鴾', '鷦', '鷎', '鴢', '鴿', '鵵', '鵼', '鴝', '鶟', '鶊', '鵺']
鵖: ['鴭', '鵙', '殦', '鴮', '鵐', '鴖']
鵗: ['鷆', '鸜', '鶙', '鵜']
鵘: ['鴰']
鵙: ['鴭', '鴅', '鵖', '隝', '鶫']
鵚: ['鶻', '鵠']
鵛: ['鵾', '鶅', '鵩', '鶏', '鳻', '鴊', '鷚', '鴎', '鴓', '鷣', '鷓', '鴖', '鶍', '鷗', '鷊']
鵜: ['鳷', '鷆', '鶙', '鵗']
鵝: ['鵅', '鴡', '鵍', '鵩', '鵬', '鴘', '鷜', '鷀', '鷚', '鸛', '鷣', '鴟', '鶹', '鶍', '鸓', '鷉']
鵞: ['鸞', '鷔']
鵟: ['鴜']
鵠: ['鵚', '鶻', '鴳']
鵡: ['鷾', '鵋', '鶡', '鷭', '鶔', '鶮']
鵢: ['鳷', '鴭', '鴡', '鶉', '鶺', '鶙', '鵱', '鷓', '鵓', '鷞', '鵧']
鵣: ['鴭', '鶂', '鴳', '鴅', '鶙', '鵁', '鵪', '鵺', '鵃', '鶇', '鶫']
鵤: ['鵭', '鷬', '鶎', '鳺', '鷄', '鷠', '鶆', '鷍', '鴣', '鶁', '鴶', '鳩']
鵧: ['鵾', '鵍', '鶺', '鴵', '鴪', '鴎', '鵢', '鴖', '鴧']
鵨: ['鵅', '鵍', '鵳', '鴂', '鶬', '鵴', '鴘', '鵒', '鴆', '鳭', '鴧']
鵩: ['鸘', '鶞', '鷉', '䳭', '鴵', '鵬', '鵝', '鵛', '鶌', '鷣', '鴖', '鷊', '鸍']
鵪: ['鴾', '鵣', '鷎', '鶴', '鶚', '鶴', '鴝', '鶊', '鵺', '鵯', '鶇', '鶫']
鵫: ['鴸', '鴳', '鷱', '鵵', '鴝', '鶟', '鵯']
鵬: ['鵾', '鸀', '鶞', '鵩', '鶥', '鴵', '鷜', '鵝', '鵽', '鷀', '鷚', '鸛', '鵷', '鷣', '鶹', '鷗', '鷊', '鸍', '鷉']
鵭: ['鶎', '樢', '鳺', '鐘', '鵤', '鴣', '鳼', '鏣', '鏪', '謞', '鳩']
鵯: ['鴸', '鴾', '鴒', '鷱', '鵵', '鵪', '鵫', '鴝']
鵰: ['鷴', '鵕', '鶠', '鴫']
鵱: ['鶅', '鴡', '鵍', '鶺', '鶏', '鶙', '鷓', '鵢', '鵓', '鷞']
鵲: ['鶛', '鶜']
鵳: ['鶣', '鶎', '鵍', '鵨', '鶕', '鶬', '鵴', '鴘', '鷯', '鶒', '鷏', '鶵', '鶁', '鴺', '鷓', '鴲', '鵸', '鷉']
鵴: ['鳰', '鵅', '鶎', '鵍', '鵳', '鴂', '嶋', '鵨', '鶕', '鶲', '鶬', '鴘', '鵒', '鶜', '鶆', '鷏', '鴆', '鴓', '鷍', '鶁', '鴺', '鴲', '鶍', '鵸', '鳩']
鵵: ['鶧', '鴳', '鷦', '鵕', '鴱', '鴩', '鲭', '鷱', '鶴', '鴝', '鶟']
鵶: ['鶰', '鵎', '鷧', '鶪']
鵷: ['鵾', '鵍', '鴵', '鵬', '鳻', '鸚', '鷓', '鷞', '鴧']
鵸: ['鷬', '鵳', '鶓', '鶬', '鷯', '鷏', '鷷', '鶁', '鴺']
鵹: ['鴑', '鷩', '鶦']
鵺: ['鸋', '鶻', '鶂', '鴳', '鴅', '鵣', '鵕', '鶴', '鴮', '鶴', '鵪', '鷑', '鶟', '鶊', '鶫']
鵼: ['鵕', '鵵', '鵁', '鶟']
鵽: ['鵾', '鸀', '鷜', '鷀', '鷚', '鸛', '鶍', '鸓', '鷉']
鵾: ['鶅', '鴎', '鸅', '鴖', '鴲', '鶍', '鵧']
鶀: ['鲯', '錤']
鶁: ['鶣', '鶎', '鵳', '鶕', '鶛', '鶬', '鵴', '鷐', '鷯', '鶆', '鷏', '鷍', '鵸']
鶂: ['鶻', '鴳', '鴅', '鵣', '鵕', '鴢', '鵁', '鴝', '鶟', '鵺', '鵃', '鶋']
鶄: ['鷾', '鶈', '鶮']
鶅: ['鵾', '鵱', '鸚', '鵛', '鴓', '鶹', '鷓', '鴖', '鶍', '鷞', '鷗', '鷊']
鶆: ['鶎', '鵳', '鴂', '鵨', '鶓', '鶬', '鵴', '鴘', '鷯', '鷐', '鴆', '鷍', '鵤', '鵏', '鶁']
鶇: ['鴭', '鵊', '鵣', '鶴', '鶙', '鶴', '鵪', '鶟', '鶊', '鵃', '鶫']
鶈: ['鷾', '鸏', '鶄', '鷡', '鷋', '鶔', '鶮']
鶉: ['鵍', '鶺', '鶕', '鶙', '鷓', '鵢', '鵓', '鶍', '鴧']
鶊: ['鴳', '鵕', '鴢', '鶴', '隝', '鵪', '鶟', '鵺', '鶇', '鶫']
鶋: ['鶻', '鶂', '鴅', '鷵', '鵐', '翵', '鶌']
鶌: ['鵩', '鶸', '鶥', '鸜', '鷵', '鸚', '鷗', '鶋']
鶍: ['鵾', '鸀', '鶉', '鶕', '䳭', '鵝', '鵽', '鷚', '鶜', '鸛', '鴟', '鶹', '鸅', '鴖', '鴲']
鶎: ['鵍', '鵳', '鶲', '鵴', '鷯', '鷐', '鶜', '鶆', '鷍', '鶁']
鶏: ['鷚', '鴺']
鶒: ['鵳', '鵴']
鶓: ['鶘', '鶣', '鷬', '鷀', '鷐', '鵸']
鶔: ['鵎', '鶈', '鵄', '鵋', '鷋']
鶕: ['鵍', '鵳', '鶛', '鶬', '鷏', '鴟', '鴲', '鶍']
鶖: ['鵥']
鶘: ['鶓', '鶲', '鴘', '鷀', '鷐', '鷂', '鷅', '鶵', '鴟', '鸓']
鶙: ['鸋', '鴭', '鶉', '鵣', '鵗', '鷓', '鵢', '鵓', '鷞', '鵜', '鶇', '鶫']
鶚: ['鴅', '鴮', '鵪', '翵']
鶛: ['鶕', '鷐', '鷏', '鷷', '鶁', '鴟', '鴲', '鸓', '鵲']
鶜: ['鶎', '鵴', '鴘', '鷍', '鵲']
鶝: ['鵎', '鵑']
鶞: ['鵩', '鶥', '鵬', '鷊', '鷉']
鶟: ['鶂', '鴳', '鷎', '鵕', '鶴', '鶴', '鵵', '鵁', '鵼', '鵫', '鴝', '鶊', '鵺']
鶠: ['鷴', '鵰']
鶡: ['鵄', '鶔']
鶢: ['鷄', '鵎', '鸐', '謞']
鶣: ['鷬', '鶎', '鵳', '鶓', '鶬', '鷐', '鷳', '鵏', '鶵', '鶁', '鸆', '鷡', '鶶']
鶤: ['鷤']
鶥: ['鶞', '鷵', '鷗']
鶦: ['鷺', '鷺', '鵹', '鷩', '鷽', '鷪', '鷲', '鸎']
鶧: ['鴳', '鷦', '鷎', '鴱', '鴩', '鵵', '鴁']
鶨: ['鶰', '鸏', '鶲', '鷄', '鸆', '鷡']
鶩: ['鴦', '鬵']
鶪: ['鷬', '鷶', '鶰', '鴠', '鴞', '鷃']
鶫: ['鴭', '鵙', '鴅', '鵊', '鵣', '鶴', '鶙', '鴮', '鴿', '鶴', '鵁', '鵪', '鶊', '鵺', '鵃', '鶇']
鶬: ['鵍', '鵳', '鵨', '鶕', '鶛', '鵴', '鴘', '鵒', '鷯', '鷐', '鷏', '鴆', '鳭', '鶵', '鶁', '鴺', '鴟', '鷓', '鵸', '鷉']
鶮: ['鷾', '鶄', '鶈', '鵡', '鶡']
鶯: ['鷺', '鷺', '鴛']
鶰: ['鷬', '鵈', '鷧', '鵶', '鶪', '鷁']
鶲: ['鶘', '鷶', '鶎', '鶛', '鵴', '鴘', '鵝', '鷐', '鶵', '鶨', '鶶']
鶴: ['鴳', '鶴', '鶟', '鵺', '鶇', '鶫']
鶵: ['鶘', '鷬', '鷶', '鵳', '鶲', '鶬', '鵝', '鷐', '鷒', '鷷', '鷃', '鷂', '鷅', '鴺', '鴟', '鷁', '鸓', '鷉']
鶶: ['鶣', '鶛', '鶲', '鷐', '鷏', '鷷', '鴟', '鸓']
鶷: ['鸇']
鶸: ['鸚', '翵', '鶌', '鸍']
鶹: ['鵾', '鶅', '鸀', '鶥', '鵬', '鷜', '鵝', '鵽', '鷚', '鸛', '鸚', '鴲', '鶍', '鷗', '鸍', '鷉']
鶺: ['鵅', '鵍', '鶉', '鵱', '鵢', '鷞', '鵧', '鴧']
鶻: ['鶂', '鴅', '鵺', '鵠', '鶋']
鶼: ['鷡']
鷀: ['鶘', '鶛', '鷜', '鵝', '鵽', '鷚', '鷃', '鵏', '鷣', '鴟', '鸓', '鷉']
鷁: ['鷬', '鷶', '鶰', '鷄', '鷐', '鴣', '鷅', '鶵', '鵑']
鷂: ['鶘', '鷀', '鷐', '鷒', '鷅', '鶵', '鴟']
鷃: ['鷀', '鶵', '鶪']
鷄: ['鷬', '鷶', '鶰', '鶲', '鷚', '鷒', '鵤', '鵶', '鷁', '鶨', '鶢', '鶪']
鷅: ['鶘', '鷒', '鷷', '鷂', '鶵', '鴺']
鷆: ['鳷', '鵗', '鴖', '鵜']
鷇: ['縠', '轂', '穀', '糓']
鷉: ['鶘', '鶞', '鵳', '鵩', '鶬', '鵬', '鵝', '鵽', '鷀', '鷚', '鷐', '鷂', '鶵', '鴟', '鷣', '鶹', '鸂', '鸓']
鷊: ['鶅', '鶞', '鵩', '鷵', '鴖']
鷋: ['鷠', '鶈', '鷡', '鶔']
鷍: ['鶎', '鴂', '鶕', '鵴', '鴘', '鶜', '鶆', '鷏', '鳭', '鴗', '鶁']
鷎: ['鶧', '鴾', '鵕', '鴢', '鷱', '鵪', '鴝', '鶟']
鷏: ['鵳', '鶕', '鶛', '鶬', '鷷', '鴺', '鴟', '鵸']
鷐: ['鶘', '鷶', '鶎', '鶛', '鶓', '鶲', '鶬', '鸐', '鷀', '鷳', '鷒', '鴞', '鷃', '鵏', '鷂', '鶵', '鶁', '鴟', '鷁', '鸓', '鶶', '鷉']
鷑: ['鸋', '鵊', '鸚', '鵺']
鷒: ['鶰', '鷄', '鷐', '鷳', '鷷', '鷂', '鷅', '鶵']
鷓: ['鶅', '鵅', '鵍', '鵳', '鶉', '鶬', '鶙', '鳻', '鵱', '鵛', '鴓', '鵷', '鵢', '鴖', '鷞', '鵜', '鴧']
鷕: ['鷥']
鷖: ['鷙', '鸞', '鸗', '鷘', '鸉']
鷗: ['鵾', '鶅', '鶞', '鶥', '鸜', '鵬', '鷵', '鸚', '鵛', '鶌', '鼱', '鶹', '鷊', '鸍']
鷘: ['鸉', '鷟']
鷙: ['鸗']
鷚: ['鸀', '鵩', '鶏', '鵬', '鷜', '鵝', '鵽', '鷀', '鸛', '鷃', '鷂', '鷅', '鶵', '鴟', '鷣', '鶹', '鶍', '鸓', '鷉']
鷜: ['鶅', '鸀', '鸖', '鵬', '鵝', '鵽', '鷀', '鷚', '鸛', '鴟', '鶹']
鷝: ['鵰']
鷞: ['鶅', '鶉', '鵊', '鶺', '鶙', '鵱', '鵷', '鷓', '鵢', '鵓', '鴧']
鷟: ['鷥', '鷘', '鬹']
鷠: ['鵤', '鷡', '鷋', '鰽', '鶔', '鰭']
鷡: ['鶣', '鸏', '鶼', '鷠', '鶈', '鸕', '鸆', '鸙', '鶨', '鷋', '鸝']
鷢: ['廩', '鏖', '鳫', '蠯']
鷣: ['鵩', '鵬', '鵝', '鷀', '鷚', '鵛']
鷤: ['鶤', '鷨', '鷼']
鷥: ['鷕', '鷟']
鷦: ['鶧', '鴸', '鴳', '鵕', '鴱', '鴩', '鵵', '鵠']
鷧: ['鶰', '鷮', '鵶']
鷨: ['鷤']
鷩: ['鵹', '鶦']
鷪: ['鷺', '鷺', '鷽', '鸎', '鶦']
鷫: ['鷸']
鷬: ['鶣', '鶰', '鶓', '鷄', '鷷', '鶵', '鷁', '鵸', '鶪']
鷭: ['鵡', '鶔']
鷮: ['鷧']
鷯: ['鶎', '鵳', '鶬', '鶆', '鷏', '鷷', '鷅', '鶁', '鴺', '鵸']
鷱: ['鶧', '鴇', '鷎', '鷴', '鴒', '鳹', '鵵', '鴝', '鵯']
鷲: ['驡', '鬹', '鶦']
鷳: ['鶣', '鸀', '鶓', '鴯', '鵬', '鸐', '鷐', '鷒', '鵏', '鶵', '鸆', '鷉']
鷴: ['鷱', '鶠', '鵰']
鷵: ['鶥', '鸜', '鶌', '鶋', '鷊']
鷶: ['鶲', '鷄', '鸐', '鷐', '鶵', '鷁', '鸓', '鶪']
鷷: ['鶛', '鷒', '鷏', '鷅', '鶵', '鴺', '鵸', '鶶']
鷸: ['鷫']
鷹: ['縻', '廪', '廬', '麎', '麠', '麌', '廬']
鷺: ['鷺', '鶯', '鷽', '鷪', '鶦']
鷼: ['鷤']
鷽: ['鷺', '鷺', '鷪', '鶦']
鷾: ['鸏', '鶄', '鶈', '鸕', '鵡', '鸙', '鶮']
鷿: ['鸎', '鷟']
鸀: ['鶲', '鴵', '鵬', '鷜', '鵽', '鷚', '鸚', '鵷', '鴟', '鶹', '鸅', '鶍', '鸓']
鸁: ['赢', '贏', '臝', '瞐', '嬴', '蠃', '驘', '羸']
鸂: ['鷉']
鸅: ['鵾', '鸚', '鵗', '鶍']
鸆: ['鶣', '鶓', '鴯', '鸐', '鷐', '鷒', '鷧', '鸕', '鵏', '鷡', '鶨']
鸇: ['鶷']
鸉: ['鷙', '鷖', '鸗', '鷘']
鸊: ['䳭']
鸋: ['鶙', '鴮', '鷑', '鵺']
鸌: ['鹱', '艧']
鸍: ['鸘', '鵩', '鶸', '䳭', '鵬', '鷵', '鶹', '鷗', '鷊']
鸎: ['鵀', '鷪', '鶦']
鸏: ['鷾', '鶲', '鶈', '鷡', '鷁', '鶨', '鸝', '鶶']
鸐: ['鷶']
鸒: ['譽']
鸓: ['鶘', '鷶', '鷉', '鶛', '鵝', '鵽', '鷀', '鷐', '鷚', '鸛', '鵏', '鶵', '鴟', '鴲']
鸕: ['鷾', '鷧', '鸆', '鷡', '鸙', '鸝']
鸖: ['鸛']
鸗: ['鷙', '鸉', '驁', '鼍']
鸘: ['鵩']
鸙: ['鷾', '鷧', '鸕', '鸆', '鷡']
鸚: ['鶅', '鶸', '鸜', '鷜', '鳻', '鷑', '鵷', '鶌', '鶹', '鸅', '鷗']
鸛: ['鸖', '鵬', '鷜', '鵝', '鵽', '鷚', '鴟', '鶍', '鸓']
鸜: ['鷵', '鵗', '鶌']
鸝: ['鸏', '鶲', '鷐', '鷡', '鶶']
鸞: ['鷖']
鸭: ['鸰']
鸯: ['鹜']
鸰: ['鸭']
鸱: ['鹚', '鹍']
鸲: ['鸼']
鸵: ['跎']
鸸: ['鹟', '鹏']
鹄: ['鹘', '鹆']
鹆: ['鹈', '鹄']
鹈: ['鹆']
鹉: ['鹖']
鹍: ['鹃']
鹏: ['鹟', '鸸']
鹖: ['鹉']
鹗: ['鹨']
鹘: ['鹄']
鹚: ['鹢', '鸱']
鹜: ['鸯', '骜']
鹟: ['鹏', '鸸']
鹢: ['鹚']
鹧: ['鹁']
鹨: ['鹗', '鸹']
鹩: ['鹲']
鹭: ['莺']
鹰: ['譍', '麑']
鹱: ['鸌']
鹷: ['舲']
鹺: ['鹾']
鹾: ['鹺']
鹿: ['度']
麃: ['黡']
麅: ['麔']
麆: ['麐', '匱', '麑']
麇: ['廪', '鏖']
麈: ['麙', '闔', '廛', '麞', '螷']
麋: ['廩', '鏖']
麌: ['鷹']
麎: ['廪', '麖', '麠', '鷹']
麏: ['麚', '廧', '麕', '麘', '麝', '麑']
麐: ['膻', '麆', '厬', '麛', '麕', '譍']
麑: ['麆', '麏', '麛', '鹰', '麘', '麝']
麔: ['麅']
麕: ['膻', '麏', '麐', '麛', '麝', '麑']
麖: ['廪', '麎']
麗: ['麗']
麘: ['麏', '麑']
麙: ['廛', '麞', '廲', '麈']
麚: ['麜', '麏']
麛: ['麕', '麑']
麝: ['麏', '麕', '麘', '麑']
麞: ['麙', '廛', '麈']
麟: ['麟']
麠: ['旜', '廪', '廬', '麎', '麌', '鷹', '廬']
麡: ['麙']
麤: ['龘', '厵']
麥: ['妾']
麦: ['叓']
麨: ['猀', '麰']
麬: ['皺']
麰: ['麨']
麲: ['鋧']
麶: ['麷']
麷: ['麶']
麼: ['廣', '麽']
麽: ['麼']
黀: ['廣']
黂: ['魔']
黃: ['羙', '芡', '黄']
黄: ['黃']
黅: ['霒']
黈: ['黊']
黊: ['黈']
黋: ['兤']
黎: ['黎']
黑: ['黒']
黒: ['黑']
黔: ['龄']
黕: ['黖', '黗', '黠']
黖: ['黕']
黗: ['黕']
黜: ['黯']
點: ['秥', '鮎']
黟: ['夥']
黠: ['黕']
黡: ['麃']
黢: ['黪']
黤: ['黦', '黯']
黦: ['黤']
黪: ['黵', '黲', '黢']
黯: ['黤', '黜']
黰: ['鎮']
黲: ['黪', '鏒']
黴: ['幑', '撇', '襒']
黵: ['黸']
黸: ['黵']
黿: ['鼄']
鼀: ['鼁']
鼁: ['鼀']
鼂: ['鼃']
鼃: ['鼂', '竈']
鼄: ['黿']
鼇: ['鼉']
鼉: ['鼇']
鼐: ['薡']
鼓: ['鼔']
鼔: ['鼓']
鼙: ['鼞']
鼜: ['藖']
鼞: ['鼙']
鼟: ['亶']
鼢: ['酚']
鼣: ['鼪']
鼤: ['鼪']
鼦: ['鼫']
鼪: ['鼤']
鼫: ['鼦']
鼱: ['鷗']
鼼: ['劓']
鼾: ['釬']
齃: ['餲']
齄: ['齆']
齆: ['齄']
齈: ['醲']
齋: ['鵉']
齌: ['齏', '憲']
齎: ['齏']
齏: ['齎', '雷', '齌', '雷']
齐: ['亓']
齒: ['歯']
齓: ['齔']
齔: ['齕', '齓']
齕: ['齓', '乾', '齔']
齖: ['齟']
齗: ['新', '龂', '齘']
齘: ['齝', '齗']
齛: ['齴']
齜: ['齡', '齭']
齝: ['鮐', '鮯', '飴', '齘']
齟: ['齖']
齠: ['軺', '鞀']
齡: ['齜', '龄']
齤: ['齧']
齥: ['齭']
齬: ['輑']
齭: ['齜', '齥']
齮: ['齴', '齺', '騎']
齯: ['輗']
齱: ['齻']
齲: ['齵', '龋']
齳: ['皹']
齴: ['齛', '齮']
齵: ['齲']
齷: ['龌']
齺: ['齮']
齻: ['齱']
齿: ['苬', '凷']
龂: ['齗']
龄: ['齡', '鈴']
龋: ['齲']
龍: ['龍']
龐: ['廎']
龑: ['鬂', '霙', '龔', '罺']
龓: ['贚']
龔: ['鬂', '龑', '罺']
龗: ['霰']
龘: ['厵', '麤', '聾']
龡: ['欳', '歒']
龥: ['顱']
豈: ['豈']
更: ['更']
車: ['稟', '草', '皐', '華', '車', '卓']
賈: ['資', '賌', '嚚', '賈', '寘', '賃']
滑: ['滑']
串: ['串']
句: ['匆', '句', '勺', '匂', '伨']
龜: ['龜']
龜: ['龜']
契: ['契']
喇: ['唎', '唃', '嗬', '喇']
奈: ['奈']
懶: ['懶']
癩: ['癩', '癞']
羅: ['羅']
蘿: ['薎', '蘿']
螺: ['螺']
裸: ['桗', '探', '课']
邏: ['邏']
樂: ['樂', '染', '桬', '樂', '樂', '槃']
洛: ['渃', '佫', '洛', '泈', '悋']
烙: ['烙']
珞: ['珞']
落: ['落']
酪: ['駱', '駱', '酪']
駱: ['騈', '駱', '路', '酪', '酪', '路']
欄: ['欄', '撋']
爛: ['爓', '燗']
蘭: ['薷', '蘭', '蘮']
鸞: ['鵞']
嵐: ['嵐']
濫: ['溋']
拉: ['抡', '朹', '抆', '扗', '扴', '柆']
臘: ['臘']
蠟: ['蝃']
廊: ['廝']
朗: ['朗']
狼: ['踉', '狼']
郎: ['郞']
來: ['乑', '来', '东', '來']
勞: ['勞']
擄: ['櫖', '摣', '橚', '樝']
櫓: ['禧', '櫓', '檂', '撸', '擼', '楂', '橞', '襜', '樻', '糩']
爐: ['爈', '擄', '熽', '爐']
盧: ['盧']
老: ['老']
蘆: ['蘪', '蕾', '蘆', '噩']
虜: ['虜']
路: ['駱', '駱', '路']
露: ['露']
魯: ['魯']
鷺: ['鶯', '鷺', '鷽', '鷪', '鶦']
碌: ['硫']
綠: ['綠']
菉: ['菉', '蒃']
壟: ['壟', '鎜', '鐾']
弄: ['弄', '羿', '竎']
籠: ['籠']
聾: ['聾', '譥']
牢: ['牢', '宝']
磊: ['磊']
賂: ['賂', '胳']
雷: ['齏', '罥', '雷']
壘: ['壘']
屢: ['屢']
樓: ['樓']
淚: ['诶']
漏: ['漏']
勒: ['勒', '勘']
肋: ['肋', '助', '劤']
綾: ['綾']
菱: ['蓃', '荾', '菱']
陵: ['陵', '朡', '睖', '陸', '陸']
讀: ['謤', '謖', '謯', '譔', '譠', '讍']
拏: ['拏', '挈']
樂: ['樂', '染', '桬', '樂', '樂', '槃']
諾: ['諾']
丹: ['丹', '冎']
寧: ['窠', '寧']
怒: ['惄', '怒']
率: ['卑', '率', '孪', '李', '率']
異: ['異']
北: ['北']
磻: ['磻']
便: ['偎', '倱', '便']
復: ['徺', '復']
不: ['不']
泌: ['佖']
參: ['参', '參']
塞: ['塞']
葉: ['蔂', '葉', '稁']
說: ['說', '說']
辰: ['泿']
沈: ['沈', '汶', '汼']
拾: ['垥', '坮', '抢', '峆', '拴', '绐', '拾']
若: ['苩', '若']
掠: ['掠']
略: ['略']
亮: ['堯']
兩: ['闳']
凉: ['凉']
梁: ['梁', '染', '梊', '粱', '栥', '榘', '桬', '柒', '槃']
糧: ['糧']
良: ['丧']
諒: ['誴', '誺']
量: ['量', '曐', '蠒']
勵: ['勵', '勪', '勴']
呂: ['呂']
廬: ['廬', '麠', '廲', '鷹']
旅: ['旅']
濾: ['濤', '濾', '懅']
礪: ['磭', '礪']
閭: ['閐', '闁', '閭', '閵', '圄', '閻']
麗: ['麗']
黎: ['黎']
力: ['力']
曆: ['磿', '暦', '曆']
歷: ['蜃', '歴', '歷']
轢: ['轢']
年: ['年']
憐: ['憐']
戀: ['戀']
撚: ['撚']
漣: ['澾', '漨']
煉: ['棟', '煉']
璉: ['瓋']
秊: ['秊', '氒', '乖', '季']
練: ['綀', '練', '錬', '竦', '鋉']
聯: ['聎', '聯']
輦: ['輦']
蓮: ['薘', '薻']
鍊: ['鍍']
咽: ['咂', '啮']
裂: ['製', '裂']
說: ['說', '說']
廉: ['庲', '廉']
捻: ['捻', '棇']
殮: ['殮']
簾: ['簾']
獵: ['镴', '擸', '鑞']
囹: ['圏', '國', '圛', '匼', '圕', '囦', '图']
寧: ['窠', '寧']
怜: ['怜']
瑩: ['縈', '瑩']
零: ['畧']
靈: ['靈', '寷']
領: ['頰']
醴: ['醴', '醯', '醏']
隸: ['隸']
惡: ['悪', '惡']
了: ['乊', '了']
僚: ['傸', '僚', '俫']
寮: ['寮']
尿: ['杘', '尿']
料: ['料']
樂: ['樂', '染', '桬', '樂', '樂', '槃']
燎: ['燎', '燷']
療: ['療', '瘵', '癴', '瘊']
龍: ['龍']
暈: ['暈']
阮: ['阮', '阶', '盶']
劉: ['劉', '剹']
杻: ['紐', '紐', '坧', '柤', '杻']
柳: ['柳', '揤', '椥']
流: ['流', '沫', '濄']
硫: ['琉', '硡', '硫', '碌']
紐: ['紐', '杻']
類: ['颏', '類', '頴']
六: ['为', '穴', '亣']
戮: ['戮']
陸: ['陵', '陵', '陸']
倫: ['倫']
崙: ['崙']
淪: ['淪']
律: ['律']
慄: ['憟', '慄']
栗: ['栗', '粟']
率: ['卑', '孪', '李', '率', '率']
隆: ['隆']
利: ['利', '刮']
吏: ['莡', '吏']
履: ['愿', '履']
易: ['易']
李: ['斈', '荸', '率', '孪', '率']
梨: ['楘', '梨']
泥: ['泥', '伲', '洉']
理: ['理']
痢: ['痸', '痭', '痏']
罹: ['罹']
裏: ['裹', '裏', '褢', '裠']
裡: ['陧', '裡']
里: ['虽', '瞾', '里']
離: ['雜']
匿: ['囷', '匱']
吝: ['各', '吝']
燐: ['橉', '燐', '僯']
璘: ['璳', '瓉']
藺: ['藺', '蕑']
隣: ['隣', '膦']
鱗: ['鱈', '鱗', '鰿', '繗']
麟: ['麟']
林: ['林']
淋: ['淋']
臨: ['臨']
立: ['立']
笠: ['笠']
粒: ['粒']
狀: ['狀']
炙: ['烮']
什: ['什']
茶: ['茉', '茅', '茶']
刺: ['剠', '刹', '刺']
度: ['鹿', '度']
拓: ['拓', '袥', '祏']
糖: ['糖', '禟', '煻']
宅: ['毛', '宅']
洞: ['洞', '渦', '淈']
暴: ['暴', '軣']
輻: ['輻']
行: ['行']
降: ['降']
見: ['見']
廓: ['廓']
兀: ['兀', '刂']
嗀: ['榖', '嗀']
﨎: ['雙']
塚: ['塚']
﨑: ['崦', '帹']
﨔: ['榫', '梈']
礼: ['糺']
福: ['稫', '褔']
靖: ['靖', '媠']
﨡: ['姓']
﨣: ['赵']
﨧: ['﨨']
﨨: ['﨧']
飯: ['鈑']
館: ['錧']
鶴: ['鴳', '鶴', '鵵', '鵪', '鴝', '鶟', '鶊', '鵺', '鶇', '鶫']
𠀀: ['冈']
